운전 배우다 원하다|운전교육 신청하러 오셨어요?
오다 수고|오시느라 수고하셨습니다
이름 무엇|성함이 어떻게 되세요?
생각 일치 쓰다 부탁|동의서 작성해 주세요.
이름 쓰다 부탁|서명해 주세요.
앉다 기다리다 부탁|앉아서 기다려 주세요.
사람 끝 상담 드리다|앞에 계신분이 끝나면 상담해 드리겠습니다.
이쪽 오다 부탁|이쪽으로 오세요.
화장실 오른쪽 있다|화장실은 오른쪽에 있습니다.
예약 주다|예약해 드리겠습니다
언제 가능하다 원하다|언제가 좋으세요?
예약 끝|예약이 되었습니다.
잘 지내다|잘 지내셨어요?
여기 앉다|여기 앉으세요.
불편 무엇?|어디가 불편하세요?
저 담당 운전 가르치다|제가 운전교육 담당입니다.
수화 또는 구화 가능하세요?|수화 또는 구화가 가능하세요?
신청 서류 주세요|응시원서 좀 보여주세요.
시험 접수 예약|시험 접수 예약부터 하세요.
월요일 괜찮아요?|월요일 어떠세요?
화요일 괜찮아요?|화요일 어떠세요?
수요일 괜찮아요?|수요일 어떠세요?
목요일 괜찮아요?|목요일 어떠세요?
금요일 괜찮아요?|금요일 어떠세요?
토요일 괜찮아요?|토요일 어떠세요?
일요일 괜찮아요?|일요일 어떠세요?
예약 오전 가능하세요?|오전로 예약 할까요?
예약 오후 가능하세요?|오후로 예약 할까요?
오늘 운전 교육 시작|오늘은 운전(기초) 교육 부터 합니다.
교육 하루 두시간 제한|교육은 하루에 두시간씩 합니다.
월요일 부터 금요일 까지 끝|월요일부터 금요일까지 합니다.
긴장 말다|긴장하지 마세요.
교육 시작|교육 시작하겠습니다.
자동차 외부 모양 확인하세요|차량외부를 확인하세요.
운전 의자 부탁|운전석에 앉으세요
앉다 몸 적당하다 조절하다|좌석을 몸에 맞게 조절하세요.
안전 띠 착용|안전 띠를 착용하세요.
오른쪽 발 브레이크 두다|오른쪽 발은 브레이크 위에 올려두세요.
변속기 P 확인|변속기가 P 에 있는지 확인하세요
열쇠 돌리는동작|엔진시동을 거세요.
계기판 바늘 확인|계기판의 바늘을 확인하세요
항상 브레이크 두다 변속기 사용|항상 브레이크를 밟은 후 변속기를 사용하세요.
P 바꾸다 D|변속기를 P 에서 D 로 바꾸세요.
전조등 켜다|전조등을 켜세요.
상향등 바꾸다|상향등으로 바꾸세요.
하향등 끄세요|하향등으로 바꾼 후 끄세요
우측 방향지시등 켜다|우측 방향지시등을 켜세요.
좌측 방향지시등 켜다|좌측 방향지시등을 켜세요.
방향지시등 끄다|방향지시등을 끄세요.
와이퍼 켜다|와이퍼를 작동하세요
출발 지시 확인 가다|출발지시를 확인 후 출발하세요.
출발 전 주차브레이크 풀다 꼭|출발전에는 꼭 주차브레이크를 풀어주세요.
운전 둥 적색 경광등|주행도중 적색 경광등이 들어오면
급정지 비상등|급정지 후 비상등 스위치를 켜세요
경광등 멈추다 비상등 끄다 다시 출발|경광등이 멈추면 비상등을 끄고 출발하세요.
끝 지시 확인 정지|종료지시가 보이면 차를 멈추세요.
출발 전 외관 확인|출발 전 차량외관을 확인하세요.
확인 없다 점수 10 빼다|미 확인시 10점 감점 됩니다.
의자 몸 적당 조절|운전석은 체형에 맞게 조절하세요.
거울 조절|후사경을 조절하세요.
안전띠 잊다 실격|안전띠 미착용 시 실격됩니다.
클러치 브레이크 정지 동시 밟다|클러치와 브레이크를 동시에 밟으세요.
변속 때 우선 클러치밟다|변속시엔 클러치부터 밟으세요.
줄발 전 주차브레이크 풀다 반드시|출발전엔 반드시 주차브레이크를 풀어 주세요.
좌 우 안전 확인|좌우 안전을 확인하세요.
주행 중 변속 때|주행 중 변속할 때에는
클러치 만 밟다|클러치만 밟고 합니다.
속도 변할때마다|변속은 속도가 변할 때 마다 합니다.
법 속도 10 초과 하지마|법정속도 10km/h 초과 금지 입니다.
지정 차로 유지|지정차로를 유지하세요.
안전 거리 유지 꼭|안전거리를 반드시 유지하세요.
우선 브레이크 밟다|우선 브레이크를 나눠 밟은 후
속도 30 이하 줄이다|속도 30km/h 이하로 감속되면
클러치 브레이크 밟다 정지|클러치와 브레이크를 밟고 정지하세요.
2~3회 브레이크 밟다|충분한 거리에서 브레이크를 2~3회 밟으세요.
정지 중 브레이크 그대로|정지중엔 브레이크를 밟고 계세요.
신호 대기 변속기 N|신호대기시엔 변속기를 중립으로 하세요.
30m 전 방향등 켜다|30m 전 방향지시등을 작동하세요.
거울 안전 확인|후사경으로 안전을 확인하세요.
위험 때 양보 먼저|위험할땐 양보부터 하세요.
안전 확인 바꾸다 꼭|반드시 안전확인 후 변경하세요.
점선 만 바꾸다 가능|변경시엔 점선 부분에서 만 가능합니다.
좌회전 신호 지시 지키다|좌회전시 신호의 지시에 따라야 합니다.
유도 선 따라가다|유도선을 따라 진행하세요.
1차선 출발 마지막 계속|1차선에서 출발하면 끝까지 유지하세요.
우회전 전 좌우 확인|우회전 진입 전 좌우를 확인하세요.
횡단보도 녹색 신호 정지|보행자 신호가 녹색인 경우엔 일시 정지하세요.
우회전 후 사람 없다 확인 가다|우회전 후 보행자가 없으면 서행으로 통과하세요.
좌회전 동시 신호 가능|좌회전 또는 동시 신호시 가능합니다.
앞 적색 좌우 신호 녹색|전방 신호는 적색이고 보행자 신호가 녹색일 때
점선 유턴 꼭|반드시 점선 안에서 유턴하세요.
학교 주변 천천히|학교 주변에서는 서행하세요.
최고 제한 속도 30|최고제한 속도는 30Km/h 입니다.
구역 주차 3분 이내|지정 구역안에 3분내에 주차해야 합니다.
차량 실선 간격 1m 유지|차량과 실선의 간격을 1m 정도 유지하면서 진입하세요.
우측 후사경 연석 맞추다 정지|우측 후사경으로 연석에 맞춰 정지하세요.
핸들 우측으로 돌림 끝 후진|핸들을 우측으로 끝까지 돌리고 후진하세요.
좌측 후사경 모서리 안쪽 정지|좌측 후사경을 보면서 모서리 안쪽에 맞춰 정지하세요.
핸들 좌측으로 돌림 끝 후진|핸들을 좌로 끝까지 돌린 후 계속 후진하세요.
실선 차량 평행 정지|실선과 차량이 평행이 되면 정지하세요.
핸들 우측 1.5바퀴 돌리다|핸들을 우측으로 1.5바퀴 풀어주세요.
변속기 P 바꾸다 주차브레이크 올리다|변속기를 P 로 바꾸고 주차브레이크를 올리세요.
지정 곳 이동|지정장소로 이동 후
정지 P 마지막 시동 끔|차량을 정지하고 변속기를 P 변속 후 시동을 끄세요.
안전띠 풀다 하차|안전띠를 풀고 하차하세요.100m 걷다 부탁|100 미터를 걸어가십시오
10년 전 부터 그 소식 모르다|10년 전부터 그와 소식이 끊겼어요
10분 동안 쉬다|10분간 쉽시다
5시 이후 아무것 때 좋다|5시 이후에는 아무 때나 좋습니다
5시간 더 가다 필요|5시간쯤 더 가면 돼요
5월 말 정도|5월말 경입니다
가게 앞 내리다 부탁|가게 앞에 내려 주시겠어요
가다 중 길 잊다|가는 도중에 길을 잃었어요
가능 때 빨리 알리다 달라다 부탁|가능한 한 빨리 저에게 알려 주시겠습니까
가망 없다|가망이 없어요
가장 좋다 가수 누구|가장 좋아하는 가수는 누군가요
가장 좋다 운동 무엇|가장 좋아하는 운동은 무엇인가요
가장 편하다 시간 언제|가장 편리한 시간이 언제입니까
가족 이야기 부탁|가족에 대한 얘기 좀 해 주시겠어요
가족 수 얼마|가족이 몇명이나 되세요
각자 돈 내다|각자 부담합시다
어제 밤 저녁 식사 무엇|간밤의 저녁 식사가 어땠어요
감기 낫다 무엇|감기는 다 나았니
감기 낫다 약 좋다 무엇|감기에 좋은 약이 있나요
감사합니다|감사합니다
감사합니다 하지만 안하다|감사합니다만 사양하겠습니다
매우 비싸다|값이 너무 터무니없이 비싼 것 같았어요
함께 매우 재미있다|같이 보낸 모든 순간이 정말 재미있었습니다
신경 하지마|개의치 마십시오
개인 문제 상의 원하다|개인적인 문제를 상의드리고 싶은데요
일 오래되다|거기서 근무한지 오래 됐습니까
멈추다|거기서 멈춰
거기 일 발생 무엇 살피다 필요|거기서 무슨 일이 벌어지고 있는지 잘 봐야 해요
거리 얼마|거리가 얼마나 됩니까
걱정 일 있다 아마|걱정되는 일이 있었나요
걱정 하지마 말 해보다|걱정말고 말해요
걱정 하지마|걱정하지 마세요
걱정 필요 없다|걱정할 것 하나도 없어요
건강 방법 무엇|건강의 비결은 무엇입니까
모습 건강 보다|건강해 보이시는 군요
걷다 약 10분 정도|걸어서 약 10분 거리입니다
게시판 내용 무엇|게시판에 뭐라고 씌어 있는 거예요
결정 잘하다 무엇|결정하셨습니까
나 잘못 무엇|제가 뭘 잘못했나요
경기 8시 시작|경기는 8시에 시작될 겁니다
경기 점수 똑같다 끝|경기는 무승부로 끝났습니다
경마장 가다 무엇|경마장에 안 가실래요
계속 똑바로 걷다|계속 똑바로 가세요
당신 계획 그대로 행동 존경|계획에 충실하는 당신이 존경스럽습니다
계획 그대로 행동 성공 가능 아마|계획을 잘 실행하면 성공할 겁니다
원래 살다 나라 돌아가다 언제|고국에 언제 돌아가실 계획입니까
고맙다 한 달 이후 갚다|고마워 한 달 뒤에 갚을께
고맙다|고맙습니다
고속도로 약 50분 정도 곳 있다|고속도로로 약 50분 거리에 있습니다
고의 아니다|고의로 그런게 아닙니다
예전 음악 좋다|고전 음악을 좋아합니다
태어나다 곳 어디|고향이 어디세요
곧 경찰 보내다|곧 경찰을 보내 드리지요
곧 괴롭다 사라지다 좋다 아마|곧 시달림에서 벗어 났으면 좋겠군요
곧 알아 아마|곧 알게 될 겁니다
바로 가다|곧바로 가세요
바로 가다 두번째 길 있다|곧장 가셔서 두번째 마주치는 길에 있습니다
쭉 가다 있다|곧장 가시면 있어요
골프 관련하다 면 이기다 못하다|골프에 관한 것이라면 자네도 그에게 못 당할걸
공부 못하다|공부가 뒤져 있어요
공부 시작 필요하다|공부를 해야겠어요
자리 없다 면 알리다|공석이 있으면 알려 드리겠어요
똑같다 무엇|공통점이 뭔가요
과거 그대로 두다|과거는 과거로 묻어 둡시다
과거 묻다 하지마|과거를 묻지 맙시다
관광 좋다 곳 소개 부탁|관광할 만한 데를 몇군데 소개해 주시겠습니까
관리 사람 연락 끝 무엇|관리인에게 연락하셨나요
괜찮다|괜찮아요
맛있다 매우|굉장히 맛있습니다
교육 전공 배우다 중|교육학을 전공하고 있습니다
구급차 보내다 달라다|구급차를 보내주세요
돕다 못하다|구제불능이군요
나라 어디|국적이 어디시죠
굻다 죽다 보다 더 낫다|굶어 죽는 것보다 그게 낫쟎아요
중요하다 물건 두다 어디|귀중품을 어디에 보관하세요
귀찮다 주다 미안하다|귀찮게 해서 미안합니다
규칙 그대로 행동 좋다|규칙대로 하는 것이 좋을 겁니다
거기 곳 가다 약도 그리다 부탁|그 것으로 가는 약도를 좀 그려 주시겠습니까
거기 곳 가다 방법 알다 무엇|그 곳에 어떻게 가는지 그 방법을 알아 냈나요
교차로 곳 네 군데 멈추다 표시 있다|그 교차로에는 네 군데에 멈춤 표시가 있습니다
거기 영화 보다 곳 지금 영화 무엇|그 극장에선 뭐가 상영중이죠
근처 곳 가장 눈 보다 가능 건물 무엇|그 근처에 가장 눈에 띄는 건물은 무엇입니까
노래 기타 연주 가능 질문|그 노래 기타로 연주할 줄 아세요
노래 듣다 예전 추억 생각나다|그 노래를 들으니 그리운 옛 추억이 되살아나는 군요
말 경주 우승|그 말이 가까스로 그 경주에서 우승했어요
문제 대하다 생각 많다 끝|그 문제에 대해서는 많이 생각해 봤어요
문제 대하다 동감|그 문제에 대해서는 저도 동감입니다
그 조심 경계 좋다|그 사람 경계하는 편이 좋아요
그 나이 50 60대 정도|그 사람 중년티가 나더군요
그 틀리다 없다 분명 농담 이야기 아마|그 사람 틀림없이 농담으로 한 말일 거예요
그 친밀 친구 하지마|그 사람과 사귀지 마세요
그 연락 방법 무엇|그 사람과 연락을 하려면 어떻게 해야 되요
그 전화 바꾸다 부탁|그 사람에게로 전화를 돌려 주시겠습니까
그 건강 잘 살다|그 사람은 건강하게 잘 재냅니다
그 나 돈 사용 많다|그 사람은 나에게 돈을 너무 많이 받았어요
그 아무것 일 없다 모습 똑같다 모임 갔다|그 사람은 아무 일 없었던 듯이 모임에 나갔다
그 자기 하다 일 알다 무엇|그 사람은 자기가 해야 할 일을 알고 있나요
그 지위 낮다 군인|그 사람은 졸병에 불과하죠
그 믿다 하지마|그 사람을 너무 믿지 마세요
그 말 퍼지다 막다 방법 무엇|그 사람이 말을 퍼뜨리지 못하게 뭘 주면 되지요
그 말 진짜 아니다 아마|그 사람이 한 말은 진담이 아니겠지요
그 생각 머리 아프다|그 사람이라면 진절머리가 나요
그 다가가다 시계 고치다 달라다 말 부탁|그 사람한테 가서 이 시계 좀 고쳐 달라고 그러세요
그 시합 보다 괜찮다 무엇|그 시합 볼 만하던가요
아버지 아들 똑같다|그 아버지에 그 아들이군요
그 이야기 잊다 부탁|그 얘긴 잊어버리세요
그 여자 작다 목소리 이야기|그 여자는 뭔가를 작은 소리로 소곤거렸다
그 여자 중상 속이다 있다|그 여자는 중상모략을 하고 다니는 사람이예요
그 여자 보다 생각나다 사람 있다|그 여자를 보면 누가 생각납니까
그 여자 커피 가지다 오다 말 전달 부탁|그 여자한테 커피 한잔 가져오라고 해 주시겠어요
연주 모이다 곳 시작 시간 해 지다 이후|그 연주회는 해 진 직후에 시작합니다
그 영화 마음 들다 무엇|그 영화 마음에 드십니까
그 영화 내용 명백하다 기억|그 영화 줄거리가 내 기억에 생생히 남아 있어요
그 영화 시간 3시간|그 영화는 3시간 짜리예요
그 영화 2달 동안 나오다 중|그 영화는 두달째 상영되고 있어요
그 영화 소름|그 영화는 정말 소름끼쳤어요
그 영화 영향 눈물 감동 있다|그 영화를 보면 뭔가 찡하고 가슴에 와 닿는 게 있을 겁니다
방법 가르치다 부탁|그 요령을 가르쳐 주시겠어요
그 음악 나 취향 다르다|그 음악은 나의 취향에 맞지 않아요
그 이야기 듣다 생각나다 무엇|그 이야기를 들으니까 뭐가 떠오릅니까
그 자리 가득 끝|그 자리가 이제 막 찼는데요
전화 요금 빼다|그 전화 요금을 제해 드리겠습니다
그 관련하다 대하다 생각 시간 달라다|그 점에 관해 생각 좀 하게 시간을 주시겠어요
그 책 읽다 끝|그 책 다 읽었어요
그 책 가지다 안하다 대하다 사과 원하다|그 책을 안 가져온 것에 대해 사과 하겠어요
그 축구 경기 보다 끝 무엇|그 축구경기 보셨어요
그 타이 당신 입다 옷 잘하다 어울리다|그 타이는 당신 옷에 잘 어울립니다
그 회사 퇴직금 있다|그 회사는 정년 퇴직금 계획이 잘 되어 있나요
그 회사 일 시간 얼마|그 회사에 근무하신 지 얼마나 됐습니까
그 회의 참석 안되다|그 회의에는 출입금지입니다
그 생각나다 누구|그가 누구라고 생각하세요
그 넘어지다 발목 삐다|그가 미끄러져 넘어져서 발목을 삐었대요
그 영화 보다 가다 시간 가능 모르다|그가 영화 구경 갈 시간이 있는지 모르겠어요
괜찮다|그거 괜찮겠군요
굉장하다|그거 굉장하군요
그거 주다 안하다 괜찮다|그거 돌려 주지 않아도 좋습니다
그거 사다 얼마|그거 얼마 주고 샀니
그거 사다 잘하다|그거 잘 사셨군요
그거 정말 좋다|그거 정말 좋은데요
그거 잘 어울리다|그거 참 잘 어울립니다
그거 TV 보다 끝|그거 TV에서 봤습니다
그거 나 마음대로|그거야 내 마음대로죠
그거 2층 곳 있다|그건 2층에 있습니다
걱정 하지마|그건 걱정하지 마세요
그거 예전 방식|그건 구식이예요
법 때문|그건 규정 때문이예요
그거 당신 딱|그건 당신한테 딱 들어맞아요
그건 상황 따라 다르다|그건 사정에 따라 다르죠
그거 쉽다|그건 식은죽먹기예요
그거 아마 나이 차이 때문|그건 아마도 세대차이일 거예요
그거 매우 쉽다|그건 아주 식은죽 먹기라고요
그거 엉터리 아마|그건 엉터리였는지도 몰라요
그거 둘 비밀|그건 우리 둘 사이만 아는 비밀이야
그거 의심 필요 없다|그건 의심의 여지가 없어요
그거 문제 아니다|그건 전혀 별문제입니다
그거 나 잘못 아니다|그건 제 잘못이 아니예요
그거 나 생각 부족 때문|그건 제가 생각이 부족했기 때문이예요
그거 기대 지나치다|그건 지나친 기대예요
그거 가지다 부탁|그걸 가지세요
그거 생각 심하다 지나치다 하지마|그걸 너무 심각하게 받아들이지 마세요
그거 다 먹다 하지마 다음 먹다 위해 조금 두다|그걸 다 먹지 말고 나중에 먹게 좀 남겨 둬요
그거 공짜 주다|그걸 당신에게 꽁짜로 드리겠어요
안타깝다|그것 참 안됐군요
마찬가지|그것도 마찬가지일 거예요
효과 없다 아마|그것도 역시 효과가 없을 거예요
그것 부르다 무엇|그것들을 뭐라고 부릅니까
그것 뿐 알다|그것밖에 아는 것이 없습니다
그것 대해 나 가능 방법 무엇 찾다 해보다|그것에 대해 내가 어떻게 할 수 있을지 알아보겠다
그것 대해 생각 많다 경험 없다|그것에 대해 많이 생각해 보지 않았어요
그것 공부 단어 실력 발전 아마|그것으로 공부하면 단어실력이 많아 늘 겁니다
신경 없다|그것은 대수롭지 않아요
모두 동의 결정 끝|그것은 만장일치로 결정되었습니다
문제 없다|그것은 문제없어요
비밀 부탁|그것은 비밀로 합시다
그것 죽다 살다 문제|그것은 생사가 달린 문제입니다
그것 당신 잘하다 어울리다|그것은 정말 당신한테 잘 어울립니다
그것 처음 보다 반하다|그것은 첫눈에 반한 것이었어요
그것 이용 필요|그것을 이용하셔야 됩니다
그것 자랑 이유 있다|그것을 자랑할 만한 충분한 이유가 있네요
그것 중지|그것을 중지하도록 하세요
그것 이용 노력 해보다|그것을 최대한 잘 이용해 봅시다
그것 특별 맞추다|그것을 특별히 맞추었습니다
그것 시도|그것을 한번 시도해 보겠다는 거죠
그것 괴롭다|그것이 괴롭네요
그것 당신 유익 질문|그것이 당신에게 유용합니까
그것 무엇 따르다 다르다|그것이 뭐냐에 달려있죠
그것 사실 알다 있다|그것이 사실이라는 것을 알고 있어요
그것 나 필요하다|그게 난 필요해요
그거 더 근사하다|그게 더 근사하네요
그거 가치 있다|그게 모두 그럴 만한 가치가 있었습니다
그거 무엇 말|그게 무슨 말이죠
그거 무엇 책|그게 무슨 책이죠
그거 좋다 무엇|그게 뭐가 그리 좋아요
그거 사실 질문|그게 사실인가요
그거 사용 있다 아마|그게 쓸모가 있을 때가 있을 거예요
그거 아직 있다 무엇 찾다 해보다|그게 아직 거기 있는지 보세요
그거 전부 질문|그게 전부인가요
그거 전부|그게 전부입니다
그거 정말 미치다|그게 정말 미치게 만들어요
그거 문제 크다|그게 큰문제이군요
그거 확실 질문|그게 확실한가요
그거 트리다 없다|그것은 틀림없어요
그거 문제 아니다|그까짓 것 문제될 것 없습니다
그냥|그냥 그래
그냥 자리 그대로|그냥 그자리에 있으면 돼요
그냥 인사 목적 방문|그냥 인사하려고 들렀어요
그녀 저기 남자 반하다|그녀가 그에게 홀딱 반한 것 같애
그녀 나 약속 깨다|그녀가 나를 바람 맞췄어요
그녀 당신 이용 아마|그녀가 당신을 이용한 것 같은데요
그녀 돌아오다 언제|그녀가 언제쯤 돌아올 것 같아요
그녀 통화 중 끊다 예의 없다|그녀가 통화 도중 전화를 무례하게 끊어 버렸어요
그녀 간호사 자격 맞추다|그녀는 간호원으로는 적격이예요
그녀 최근 고등학교 졸업 끝|그녀는 고등학교를 갓 나왔습니다
그녀 그림 예쁘다 분별 눈 힘 있다|그녀는 그림을 감상할 줄 아는 심미안이 있어요
그녀 기억 잘하다|그녀는 기억력이 굉장히 좋아요
그녀 나 영어 가르치다 대신 나 피아노 가르치다 돕다|그녀는 내가 영어를 가르쳐 주는 댓가로 나에게 피아노를 가르쳐 줘요
그녀 노래 잘하다|그녀는 노래를 잘한다
그녀 대학교 퇴학|그녀는 대학에서 퇴학당했다
그녀 돈 내다 없다 질문|그녀는 돈을 잘 안 내려고 하나요
그녀 학교 동갑 가운데 두드러지다|그녀는 동급생 중에서도 두드러집니다
그녀 질색|그녀는 딱 질색이야
그녀 자신 생각 확실 있다|그녀는 뚜렷한 주관을 가지고 있어요
그녀 반 1위|그녀는 반에서 1등이예요
그녀 태어나다 이전 기술 가지다 있다|그녀는 소질이 있어요
그녀 손 기술 좋다|그녀는 손재주가 좋아요
그녀 신경질 때문 죽다 정도|그녀는 신경질나서 죽을 지경에 있어요
그녀 음악 경험 또 지식 깊다|그녀는 음악에 조예가 깊습니다
그녀 대학 탈퇴 결정|그녀는 대학을 중퇴하기로 결정했다
그녀 노래 진짜 잘하다|그녀는 타고난 가수예요
그녀 한국 역사 자세하다 알다|그녀는 한국사에 정통합니다
그녀 말 예의 없다 항상|그녀는 항상 교양없는 말만 해요
그녀 영화 곳 인도 돕다 필요|그녀를 영화관에 데리고 가야겠어요
그녀 우리 모임 회원 가입 돕다|그녀를 우리 모임의 회원으로 가입시켰습니다
그녀 위하다 기부|그녀를 위하여 기부금을 거둡시다
그녀 아이디어|그녀에게 좋은 생각이 번뜩 떠올랐다
그녀 인사 경험 없다|그녀와 인사를 한 적이 없는 것  같아요
그녀 옷 유행 끝|그녀의 옷은 유행에 안 맞아요
그녀 잔소리 듣다 머리 아프다|그녀의 잔소리 듣는 것에 아주 진절머리가 났어요
그녀 전화 항상 통화 중|그녀의 전화는 항상 통화중이지요
그녀 혼자 돈 벌다 고생 대학 다니다|그는 고학으로 대학을 나왔어요
그 괴롭다 중|그는 괴로워 하고 있어요
그 예술 만들다 만점 주다|그는 그 작품에 만점을 주었습니다
그 혼자 악하다 뉘우치다|그는 그의 사악함을 뉘우쳤어요
그 나 충고 많다|그는 나에게 많은 충고를 해 주었어요
그 매우 아프다 때문 침대 일어나다 못하다|그는 너무 아파서 침대에서 일어날 수 가 없대요
그 매우 피곤|그는 녹초가 되었다
그 나이 약 40세 정도|그는 대략 40세 안팎일 거예요
그 대학 탈퇴|그는 대학중퇴자입니다
그 도구 사용 기술 있다|그는 도구를 다루는 손재주가 있어요
그 단호 거절|그는 딱 잘라 거절했다
그 말 뿐|그는 말뿐이에요
그 망하다 때문 폐업|그는 망해서 문을 닫았습니다
그 머리 좋다|그는 머리가 참 좋은 아이예요
그 모임 때 망신|그는 모임에서 체면을 잃었어요
그 물리학 뛰어나다|그는 물리학에 뛰어난 사람이예요
그 반대 중|그는 반대하고 있습니다
그 발 빠르다|그는 발이 빨라요
그 밤 까지 공부|그는 밤중까지 공부를 해요
그 다르다 사람 듣다 대충 생각 가지다|그는 상대방이 건성으로 듣고 있는 것 같다고 생각했어요
그 공부 가르치다 준비 때문 바쁘다|그는 수업준비하느라 바쁩니다
그 수학 잘하다|그는 수학에 능해요
그 심장마비|그는 심장마비에 걸렸어요
그 나이 아직|그는 아직 어려요
그 저번 시험 점수 좋다 않다 생각 집중 뿐|그는 아직도 지난 학기에 받은 좋지 않은 성적에 집착하고 있어요
그 영화 보다 가다|그는 영화보러 갔어요
그 골프 중독|그는 요즘에 골프에 빠졌어요
그 운동 기술 있다|그는 운동신경이 발달되었다
그 입장 이익 있다|그는 유리한 입장에 있어요
그 자기 행동 불법 아니다 고집 중|그는 자기의 행동이 위법이 아니라고 주장했어요
그 자동차 사고 원인 팔 부러지다|그는 자동차 사고로 팔이 부러졌대요
그 눈치 재주 있다|그는 재치가 있어요
그 머리 좋다|그는 정말 머리가 좋아요
그 나 학교 선배|그는 제 학교 선배입니다
그 즉시 감정 따르다 연설|그는 즉흥적으로 연설했죠
그 틀리다 없다 1등 상 받다 확실|그는 틀림없이 1등 상을 탈 거예요
그 학교 성적 발전|그는 학교 성적이 매우 좋아진 것 같아요
그 그녀 좋다 있다 무엇|그도 그녀를 그렇게 좋아할까요
그들 화해 어렵다 무엇|그들과 화해하는 것은 어려울 걸요
그들 한 패|그들은 한 패거리야
시간 오래 아마|그래 세월이 걸리겠지
때문 훌륭|그래서 그렇게 훌륭하군요
원하다 하지만 돈 떨어지다|그러고 싶지만 돈이 다 떨어졌습니다
때문 생각나다|그러니까 생각나는군요
면 자세하다 내용 검사 필요|그러면 세부를 면밀히 조사해 봅시다
그냥 살다|그럭저럭 지내요
모르다|그런 건 모르겠는데요
말 하지마|그런 말씀 마십시오
말 필요 없다|그런 말씀은 하실 필요가 없는 거예요
말 안되다 알다|그런 말을 해서는 안 된다는 것 정도는 알고 있어요
사고 발생 나 잘못 책임|그런 사고가 난 것은 제 잘못이예요
사소하다 일 때문 상심 하지마|그런 사소한 일로 상심하지 마세요
당신 상황 극복 능력 부럽다|그런 상황을 극복하시는 당신의 역량이 부럽습니다
선생님 상황 극복 능력 부럽다|그런 상황을 극복하시는 선생님의 역량이 부럽습니다
이름 생각나다 없다|그런 이름은 생각이 안나는데요
나 틀리다 없다 분명|그런데 나는 틀림없이 그렇단 말이예요
우리 악수 하다|그런의미에서 우리 악수나 한번 합시다
때 영어 말 방법 무엇|그럴 경우 영어로는 어떻게 합니까
배짱 없다|그럴 만한 배짱이 없습니다
생각 아무것 없다|그럴 생각은 추호도 없어요
가능 있다|그럴 수도 있겠죠
필요 없다|그럴 필요 없습니다
다음 공연 언제|그럼 다음 공연은 언제 있죠
일주일 20불 올리다|그럼 주당 20불로 올려 주겠어요
말 가능 아마|그렇게 말 할 수도 있겠지요
말 감사하다|그렇게 말씀해 주시니 감사합니다
말 고맙다|그렇게 말씀해 주시니 고맙습니다
그대로 하다|그렇게 하세요
그대로 주다 감사하다|그렇게 해 주시면 감사하겠습니다
그대로 가능 질문|그렇게 해 주실래요
훌륭 잘하다 가능 뜻밖에|그렇게 훌륭하게 해내리라고는 미처 생각 못했어요
더 좋다|그렇다면 더 더욱 좋지요
너 만나다 원하다|그렇지 않아도 너를 만나고 싶었었는데
그 인도 생각 끝|그를 데리고 가려고 했어요
그 책임 탈퇴 좋다 아마|그를 면직시키는 것이 좋겠어요
그 살피다 계속|그를 잘 지켜 보세요
그 보다 해보다|그를 한번만 봐 보세요
충분 아마|그만하면 충분할 거예요
그 나이 65세 하지만 얼굴 젊다 보다|그분은 65세치고는 꽤 젊어 보이시더군요
그 여름 휴가 가다|그분은 여름 휴가를 떠났습니다
그 일 끝나다 가다|그분은 퇴근하셨습니다
그 무엇 사람 이야기 달라다|그분이 어떤 분인지 말 좀 해 주세요
그 사람 연결 부탁|그사람과 연결시켜 주세요
의심 필요 없다|그야 의심할 필요조차도 없지요
그 까다롭다 하지마|그에게 너무 까다롭게 하지 마세요
그 원하다 그대로 주다 이후 관계 자르다|그에게 원하는 것을 주고 그와는 관게를 끊어라
그 화나다 없다 매우 좋다|그에게 화가 난게 아니고 그를 무척이나 좋아합니다
그 보다 느끼다 무엇|그에게서 어떤 인상을 받았습니까
그 양보 협의 해보다|그와 타협을 해 보도록 하겠어요
그 강의 재미있다 하지만 목적 없다 아마|그의 강의는 재미있지만 목적이 없는 것 같아요
그 질문 바보 같다 때문 선생 신경질|그의 바보 같은 질문이 선생의 신경을 몹시 건드린 거예요
그 이야기 영화 닮다 만들다 인기 많다 아마|그의 이야기를 영화화하면 대히트를 할 것입니다
그 충고 나 마음 영향 있다|그의 충고는 내 가슴에 사무치는 데가 있어요
그 망신 주다|그의 콧대를 꺾어 놓겠어요
일 때문 그 원망 안되다|그일로 그를 원망해서는 안돼요
감사하다|그저 감사할 따름입니다
약하다 곳 응원 하다|그저 약한 쪽을 응원하고 싶어요
미안하다|그점 미안합니다
정말 감사하다|그점 정말 고맙게 생각합니다
일 때문 나 비난 가능|그점으로 비난받을 사람은 저예요
충분|그정도면 충분합니다
극장 대부분 오다 아마|극장에 거의 다 오지 않았나요
금요일 주다|금요일에 갖다 드리지요
월급 더 달라다 부탁|급료를 좀 올려 주셨으면 합니다
일 급하다 말|급한일이라고 하시는데요
급하다 가다 안하다 면 기차 놓치다|급히 서두르지 않으면 기차를 놓칠 거예요
기꺼이 순종|기꺼이 응하겠습니다
기념 우표 5장 달라다|기념 우표 5장 주세요
기다리다 미안|기다리게 해서 미안합니다
기다리다 동안 커피 마시다 질문|기다리시는 동안 커피 한 잔 드시겠어요
기대 하지마|기대하지 말아요
기름 물 점검 질문|기름과 물도 점검해 드릴까요
기부 달라다|기부 좀 해 주십시오
기분 상하다 목적 말 아니다|기분을 상하게 하려고 한 말은 아니었습니다
기분 상하다 있다 무엇 걱정|기분을 상하게 해드리지는 않았는지 모르겠네요
기분 전환 목적 밖 바람 걷다 하다|기분전환 겸 산보나 합시다
기억 잘하다|기억력이 참 좋으시군요
오다 끝 먹다 가다 낫다|기왕에 왔으니까 식사를 하는게 낫겠어요
기차 타다 곳 어디 가르치다 달라다|기차역이 어디 있는지 가르쳐 주시겠어요
기침 콧물 있다|기침이 나고 콧물이 흐릅니다
주저 없다 이야기 하다|기탄 없이 말하겠어요
기회 있다 면 노력 열심|기회가 주어진다면 최선을 다하겠습니다
기회 달라다|기회를 주세요
길 건너편 곳 있다|길 건너편에 있습니다
길 양보 부탁|길 좀 비켜 주세요
길 건너다 왼쪽 있다|길을 건너 왼쪽으로 가세요
길 안내 돕다|길을 안내할께요
길 잃다|길을 잃었습니다
꼭 아니다|꼭 그렇지는 않아요
끝까지 집요하다|끝까지 물고 늘어져요
끝까지 고집 미안하다|끝까지 우겨서 미안해요
끝 질문|끝났습니까
나 반대하다|나는 결사반대입니다
나 결심 끝|나는 굳게 결심했다

나 계획 인정|나는 그 계획에 찬성합니다
나 그 말 거짓 알다 있다|나는 그가 거짓말하고 있다는 걸 알고 있었어
나 그 선생 알다 있다|나는 그가 선생인 줄 알았어요
나 아무것 모르다|나는 그걸 전혀 모르겠어요
나 반대 안하다|나는 그것을 반대하지 않습니다
나 그녀 화내다 이유 있다|나는 그녀에게 화낼 만한 이유가 있어요
나 신경 없다|나는 그런 것에 개의치 않아요
나 그 얼굴 만 알다|나는 그를 얼굴만 알고 있습니다
나 그 존경|나는 그를 존경해요
나 그 성격 잘하다 알다|나는 그의 성격을 잘 알고 있어요
나 매우 깊다 연결|나는 너무 깊게 관여되어 있어요
나 다르다 사람 보다 나 혼자 의지|나는 다른 누구보다도 내자신에 더 많이 의존하고 있어요
나 당신 반하다|나는 당신에게 반했습니다
나 당신 자랑|나는 당신이 자랑스럽습니다
나 일 맡다 못하다|나는 더 이상 일을 맡지 못하겠어요
나 말 못하다|나는 말이 안 나왔어요
나 가장 마지막 곳 앉다 좋다|나는 맨 뒷자리에 앉기를 좋아해요
나 방금 뉴스 보다|나는 방금 뉴스를 보고 있었어요
나 연극 보다 억지|나는 억지로 그 연극을 끝까지 보았어요
나 예일 대학 들어가다 정도 점수 높다|나는 예일대학에 입학할 만큼 높은 점수를 얻었어요
나 오늘 미팅 끝|나는 오늘 미팅했어요
나 노래 꼴찌|나는 음치예요
나 책 읽다 감동 처음|나는 이렇게 감동적인 책을 읽어 본 적이 없어요
나 돈 없다 도 세상 살다 견디다 가능|나는 이세상을 돈 없이 견딜 수 있어요
나 영원 돌아오다 안하다 결정|나는 이제 영원히 돌아오지 않기로 작정했어요
나 작가 되다 결정|나는 작가가 되기로 결심했어요
나 저 스타일 싫다|나는 저런 스타일은 싫어요
나 완전 인정|나는 전적으로 찬성합니다
나 절대 그녀 신용 안하다|나는 절대로 그녀를 신용하지 않아요
나 정치 아무것 모르다|나는 정치라고는 전혀 모릅니다
나 형편없다|나는 형편없어
나 똑같다 하다|나도 같은 것으로 하겠습니다
나 똑같다 말하다|나도 그렇게 말했어요
나 처음 듣다|나도 금시초문이예요
나 다르다 사람 똑같다 살다 가능|나도 남들처럼 살아갈 수 있어요
나 당신 의견 같다|나도 당신과 같은 의견입니다
나 생각 마찬가지|나도 마찬가지 생각입니다
나 동의 진짜|나도 진심으로 동의합니다
나 반대 없다|나로서는 그것에 반대하지 않습니다
나 아무것 일 중간 멈추다 못하다|나로서는 어떤 일을 중도에서 팽개칠 수 없어요
나 고자질 끝 질문|나를 고자질 할 건가요
나 믿다 하지마|나를 꼭 믿지는 말아요
나 실망 주다 하지마|나를 실망시키지 마세요
나 영화 보다 함께 부탁|나를 영화에 데려가 주세요
나쁘다 친구 사귀다 하지마|나쁜 친구들을 사귀지 말아라
나 연락 달라다|나에게 연락해 주세요
나 귀찮다 주다 하지마|나에게 추근거리지 말아요
나 계획 모두 단계 잘하다|나의 모든 계획은 착착 진행되고 있습니다
나 만들다 새롭다 프로그램 보다 생각 무엇|나의 새 프로그램을 어떻게 생각하세요
나이 비밀 못하다|나이를 숨길 수 없어요
나이 보다 얼굴 젊다 보다|나이에 비해 젊어 보이시는 군요
나 쓸데없다 장난 하지마|나한테 쓸데없는 칭찬을 하지 마세요
나 연극 표 2장 있다|나한테 연극표가 두장 있어요
낙담 하지마|낙담하지 말아요
낚시 취미|낚시를 즐겨합니다
나 실험 결과 기대 크다|난 그 실험결과에 큰 기대를 걸고 있어요
나 그 얼굴 모습 흥미 보다 끝|난 그의 얼굴에서 흥미 있는 표정을 보았어요
나 긴장 중|난 긴장하고 있어요
나 영웅 본받다 중|난 내 영웅들의 본을 따르고 있어요
나 너 자랑|난 네가 자랑스럽다
나 그냥 농담|난 단지 농담을 했을 뿐이예요
나 당신 생각 방식 이해 백 못하다|난 당신의 관점을 충분히 이해를 못 하겠습니다
나 도박 곳 가다 안하다|난 도박장에는 절대 안 갑니다
나 배 타다 멀미 있다|난 배만 타면 배멀미를 해요
날씨 덥다|날씨가 무덥군요
날씨 좋다|날씨가 참 좋죠
다르다 사람 말 상관 없다 나 일 집중 하다|남이 뭐라고 할지라도 내 할일은 하겠습니다
다르다 사람 가능 나 가능|남이 하는 일이면 나도 할 수 있어요
다르다 사람 무엇 상관 없다 좋다 같다|남이야 뭘 하든 상관 않는 것이 좋을 겁니다
남자 맞추다 일 싫다 도 참다|남자답게 싫은 일도 참아라
나 돕다 필요 면 부탁 항상 괜찮다|내 도움이 필요하시면 언제든지 부탁하세요
나 문제 비교 문제 없다|내 문제와 비교하면 아무것도 아니예요
나 방 엘리베이터 매우 가깝다 때문 바꾸다 원하다 가능 질문|내 방이 엘리베이터에 너무 가까이 있는데 바꿀 수 있을까요
나 사무실 받다|내 사무실에서 받지요
 나 생각 당신 적극 못하다|내 생각에는 당신이 적극적이 못 되는 것 같아요
나 의견 알리다 기쁘다|내 의견을 알리게 되어 기뻐요
나 잘못|내 잘못이었어요
나 잊다|내가 깜빡 잊었군요
나 공부 내용 매우 어렵다|내가 들은 과목은 나한테 너무 어려웠어요
나 말 잘못|내가 말을 잘못했습니다
나 말 이거 다르다|내가 말하려고 한 것은 그것이 아니었어요
나 때문 망치다 아마|내가 망친것 같군요
나 문 나가다 해보다 무엇|내가 문에 나가 볼까요
나 바보 생각 질문|내가 바보인 줄 아세요
나 밖 동안 전화 있다 무엇 질문|내가 밖에 있는 동안 전화온거 있었나요
나 보다 너 성공 크다 확실|내가 보기에 너는 대성할 사람 같아
나 모르다|내가 아는 바가 아닙니다
그 아마 교수|내가 아는 바로는 그분은 교수예요
우리 반 중 나 가장 꼴찌|내가 우리 반에서 제일 뒤떨어진 것 같아요
나 좋다 드라마 놓치다 원하다 없다|내가 좋아하는 연속극을 안 놓치고 싶어요
나 말 이해 되다 질문|내가 한 말 알아들었나요
나 설명 부탁|내게 설명 좀 해 주시겠어요
나 좋다 생각 있다|내게 좋은 생각이 있어요
내려다가 홀 오른쪽 곳 있따|내려가시면 홀 오른쪽에 있습니다
나 사무실 찾다 어렵다 없다 아마|내 사무실을 찾는데 아무런 문제가 없을 거예요
내일 전화 다시|내일 다시 전화 하지요
내일 문 열다 질문|내일 문을 여십니까
내일 아침 8시 나가다|내일 아침 8시에 나가게 될 겁니다
내일 아침 가장 먼저 그 전화 하다|내일 아침 맨 먼저 그에게 전화할께요
내일 오후 시간 가능 질문|내일 오후에 시간이 있으시세요
내일 저녁 때 자리 예약 가능 질문|내일 저녁 자리를 예약할 수 있을까요
내일 당신 차 빌리다 가능 질문|내일 제가 당신의 차를 써도 될까요
내일 나라 축하 날 때문 하루 쉬다|내일은 국경일이기 때문에 온종일 문을 닫습니다
내일 도시락 가지다 오다|내일은 도시락을 갖고 오십시오
내일 쉬다 원하다|내일은 쉬고 싶습니다
내일 나 쉬다 날|내일은 제가 쉬는 날입니다
다음주까지 연기|다음주까지 연기합시다
너 공부 만|너는 공부만 하면 된다
너 너 그대로 하다|너는 너대로 해라
너 어머니 말 그대로 순종 필요|너는 어머니의 말씀을 따라야 한다
너 완전 틀리다|너는 완전히 틀렸다
여기 곳 너 만나다 생각 못하다|너를 여기서 만나게 될 줄은 상상도 못했어
너희 모두 마찬가지|너희들도 모두 마찬가지야
너희 항상 붙다|너희들은 항상 붙어다니는 구나
네 배달 가능|네 배달해 드립니다
너 나보다 낫다|네가 나보다는 한 수 위야
너 괜찮다 면 나 보다 돕다|네가 좋다면 내가 봐 줄게
너 일 발생 무엇 나 이야기 달라다|네게 무슨 일이 있었는지 그대로 내게 말해봐
놀리다 질문|놀리시는 겁니까
농담 심하다 하지마|농담을 너무 심하게 하지 말아요
이야기 누구|누가 그 얘기를 하던가요
지금 누구|누가 할 차례지
다치다 사람 누구|누구 다친 사람이 있습니까
시험 모두 잘하다|누구나 시험을 잘 보았어요
누구 상관 없다 모두 가입비 없다 회원 가능|누구든지 가입비 없이 회원이 될 수있습니다
응원 누구|누구를 응원하고 있는 거죠
누구 질문|누구시더라
아무것 말하다 경험 없다|누구한테도 말한 적이 없어요
|나 아파트 곳 낯설다 사람 오다|누군가가 제 아파트에 침입했습니다
쉽다|누워서 떡먹기예요
뉴스 또 날씨 다음 프로 무엇|뉴스와 날씨 다음 프로가 뭐지요
뉴욕 가다 중|뉴욕에 가는 중입니다
뉴욕 곳 만나다 우연|뉴욕에서 뵙게 되다니 정말 우연의 일치로군요
뉴욕 여름 때 항상 덥다 질문|뉴욕의 여름은 언제나 이렇게 덥나요
뉴욕 가다 비행기 자주 얼마|뉴욕행 비행기는 얼마나 자주 있나요
늦다 미안하다|늦어서 미안합니다
늦다 용서 달라다|늦은 것 용서해 주세요
늦다 아마|늦을 것 같습니다
다르다 사람 묻다 해보다|다른 분한테 물어 보시죠
다르다 교환 가능 질문|다른것과 교환할 수있을까요
다시 만나다 반갑다|다시 만나서 반갑습니다
다시 이야기 부탁|다시 한 번 말씀해 주시겠어요
다음 금요일 때 아이 돌보다 가능 질문|다음 금요일에 아이를 봐 주실수 있으세요
다음 기회 미루다 가능 질문|다음 기회로 미룰 수 있을까요
다음 정류장 내리다|다음 정류장에서 내리겠습니다
다음 누구|다음은 누구 차례지요
다음 당신|다음은 당신 차례입니다
다이어트 계속 운동 많다 중|다이어트를 계속하고 운동을 많이 해요
달다 좋다 질문|단 것을 좋아하세요
생각 다르다|단념하겠어요
나 때문|단지 제 탓이죠
달걀 상하다|달걀이 상했군요
담배 없다 살다 못하다|담배 없이는 단 하루도 못살 것 같아요
담배 당신 건강 해치다 위험|담배는 당신의 건강을 심히 손상시킬 수 있어요
담배 끊다 필요|담배를 끊으셔야해요
담배 많다 질문|담배를 많이 피우시나요
당신 가족 잘 살다 질문|당신 가족들은 다 안녕하신지요
당신 고향 날씨 무엇|당신 고향의 기후는 어떻습니까
당신 때문 오늘 하루 즐기다|당신 덕분에 오늘 정말 재미있게 보냈습니다
당신 배우자 태어나다 날 언제|당신 배우자의 생년월일이 어떻게 됩니까
당신 직업 관련하다 이야기 더 달라다|당신 직업에 대해 좀 더 자세히 얘기해 주시겠어요
당신 특기 무엇|당신 특기가 뭐예요
당신 방법 배우다 되다 아마|당신도 그 요령을 알게 될거예요
당신 준비 끝나다 나 항상 좋다|당신만 준비되셨다면 저는 언제라도 좋습니다
당신 손 가지다|당신에게 달려 있습니다
당신 맡기다|당신에게 맡깁니다
당신 방법 무엇 알다 질문|당신에게 무슨 비결이라도 있으세요
당신 하다 이야기 있다|당신에게 이야기할 것이 있습니다
당신 실패 결코 없다|당신은 결코 실패할 리는 없어요
당신 그 생각 버리다 필요|당신은 그 생각을 버려야 해요
당신 그거 이용 잘하다 필요하다|당신은 그것을 잘 이용해야 해요
당신 눈 예쁘다|당신은 눈이 참 예쁘군요
당신 능력 대단하다|당신은 능력이 대단하시군요
당신 딴청 중|당신은 딴청을 부리고 있군요
당신 모르다 없다|당신은 모르는게 없군요
당신 보청기 필요하다|당신은 보청기가 필요하겠군요
당신 생명 구원 사람이다|당신은 생명의 은인입니다
당신 팀 응원 어디|당신은 어느 팀을 응원하고 있지요
당신 편 어디|당신은 어느 편입니까
당신 운동 자주 얼마|당신은 얼마나 자주 운동을 하세요
당신 여가 때 무엇|당신은 여가를 어떻게 보내십니까
당신 이 일 잘하다 맞추다|당신은 이 일에 안성마춤입니다
당신 길 위험 곳 가다 중|당신은 지금 위험한 길을 가고 있어요
당신 부지런하다|당신은 참 부지런하시군요
당신 인사 잘하다|당신은 참 인사성이 밝으시군요
당신 틀리다 없다 성공 가능|당신은 틀림없이 해낼 수 있을 것이라고 믿어요
당신 말 하나 빼먹다|당신은 한 마디를 빠뜨렸어요
당신 돕다 가능 매우 기쁘다|당신을 도울 수 있다는 것은 너무나 기쁜일이죠
당신 용서|당신을 용서하겠어요
당신 견해 내 견해 매우 다르다|당신의 견해와 나의 견해는 상당히 다른 것 같군요
나 당신 대답 만족|당신의 답에 제가 만족할 겁니다
당신 살다 마을 잘하다 알다|당신의 마을을 잘알아요
당신 영어 실력 발전 놀라다|당신의 영어 실력은 놀랄 만큼 발전했어요
당신 입장 부럽다|당신의 입장이 부럽습니다
당신 목적 알다|당신의 취지를 알겠어요
당신 머리 스타일 1960년 정도 유행|당신의 헤어스타일은 60년대에 유행했습니다
당신 교훈 배우다 좋다 같다|당신이 교훈을 얻었으면 좋겠어요
당신 만일 나 상황 면 행동 무엇|당신이 만일 내 처지라면 어떻게 하겠는가
당신 무엇 하다 상관 없다 나 당신 편|당신이 무엇을 하든지 나는 당신 편입니다
당신|당신이 받아 들이는 것이 유리할 거라고 생각합니다
당신 맞다 같다|당신이 옳은 것 같아요
당신 좋다 그대로 하다|당신이 좋아하는 것을 하세요
당신 좋다 그대로 선택|당신이 좋으실 대로 선택하세요
당신 집 가다 방법 무엇|당신집에 가려면 어떻게 가야합니까
나 당신 숨기다 아무것 없다|당신에게 감추고 있는 것은 아무것도 없어요
당신 연락 힘들다|당신한테 연락하기 참 힘들어요
당신 어울리다 잘하다|당신한테 잘 어울리는 데요
당장 사용 필요 무엇|당장 사용해야 합니까
당장 눈 내리다 모습 같다|당장이라도 눈이 내릴 것 같은데요
성공 크다 가능 아마|대성공을 거둘 겁니다
대우 잘하다 무엇|대우는 잘 해줍니까
대학 때 경험 생각하다 판단 해보다|대학 시절의 경험을 살려서 판단하세요
당신 돕다 의지 가능 무엇|댁의 도움에 의지할 수 있을 까요
당신 딸 미국 나라 살다 오래 무엇|댁의 딸은 미국에 얼마나 오래 살았습니까
당신 식구 잘하다 살다 무엇|댁의 식구들은 잘 있습니까
더 참다 못하다|더 이상은 참을 수가 없어요
더 일찍 답장 못하다 죄송하다|더 일찍 답장을 못드려서 죄송합니다
더 크다 소리치다|더 크게 소리치세요
덥다 물 없다|더운물이 안나옵니다
매우 좋다|더할나위없이 좋았습니다
그거 무엇|도대체 그것들이 뭐지요
도서관 근처 있다|도서관 근처에 있습니다
돕다 필요하다 면 부르다 부탁|도움이 필요하시면 부르세요
돕다 필요 무엇|도움이 필요하신가요
도착 즉시 연락 부탁|도착 즉시 연락하세요
돈 있다 면 사다 신다|돈만 있다면 사서 신겠습니다
돈 반환 부탁|돈으로 반환해 주셨으면 하는데요
돈 낭비 하지마|돈을 낭비하고 다니지 마라
돈 돌려주다|돈을 돌려 주세요
돈 바꾸다 무엇|돈을 어떻게 바꿔드릴까요
돈 빌리다 가능 무엇|돈을 좀 빌릴 수 있을까요
돈 더 사용하다 아마|돈이 더 들 것 같군요
운전 번갈아가다 좋다|돌아가면서 운전하는 것이 좋겠어요
동네 오다 잘못|동네를 잘못 찾아오셨습니다
동반 즐기다|동반해 주셔서 즐겁습니다
되다|됐어요
둘 이든지 아무것 좋다|둘중 어떤 것이라도 좋아요
가끔 솔직 이야기 가장 좋다|때로는 솔직하게 털어 놓는 것이 최선의 길이지요
또 만나다|또 만나게 되었군요
또 알다 원하다 무엇|또 뭐 알고 싶은 것 없습니까
라디오 소리 크다 부탁|라디오 소리 좀 크게 하세요
로리 부르다 부탁|로리라고 불러 주세요
마시다 원하다 무엇|마실 것은 어떻게 하시겠어요
마시다 나 사다|마실것은 내가 내죠
마음 원하다 없다|마음이 내키지 않아요
마지막 공연 끝 언제 질문|마지막 공연은 언제 끝나죠
미국 사람 똑같다 영어 잘하다|마치 미국 사람처럼 영어를 잘하십니다
만나다 반갑다|만나서 반갑습니다
모두 잘 되다 무엇|만사가 잘 되어 갑니까
도움 필요 면 끊다 하지마 기다리다 부탁|만약 도움이 필요하시다면 끊지 말고 기다리십시오
수업 늦다 면 어떡하다|만일 수업에 늦으면 어떻게 하지요
혹시 상황 미리 준비 위하다 돈 저축 중|만일의 경우를 위해 저축하고 있어요
많다 먹다|많이 드십시요
말 보다 행동 중요|말보다는 행동이 중요해요
말씀 중 죄송하다|말씀중에 대단히 죄송합니다
말 시작 길다|말을 꺼내면 길어집니다
맞다|맞아요
하루 5시간 꼭꼭 약 하나 먹다|매 5시간마다 한 알씩 복용하세요
매우 즐기다|매우 즐거웠어요
일기 매일 쓰다 무엇|매일 일기를 씁니까
맥주 마시다 토의 하다|맥주 한잔 하면서 토의합시다
맥주 마시다 무엇|맥주 한잔 하시겠어요
맹세 무엇|맹세합니까
머리 깨지다 느끼다 비슷 아프다|머리가 깨지는 것 같이 아프다
생각 해보다|머리를 써 봐
생각 쥐어짜다|머리를 쥐어짜내 봐 
집 멋지다 가지다|멋진 집을 갖고 계신군요
메모|메모하세요
메모 주다|메모해 드리죠
메세지 보내다|메세지를 남기시겠어요
면도 필요|면도를 해야겠네요
만나다 몇 년 기간|몇 년만에 만나 뵙는군요
뉴욕 도착 몇 시간|몇 시간 더 가면 뉴욕에 착륙합니까
시카고 도착 몇 시|몇 시에 시카고에 착륙할까요
약 먹다 몇 개|몇 알씩 먹어야 하나요
몇학년|몇 학년입니까
졸업 언제|몇년도에 졸업했습니까
열다 몇 시|몇시까지 여세요
자다 며칠|몇일 밤을 주무실 겁니까 손님
모두 성적 좋다 발표 기쁘다|모두가 좋은 성적을 얻었다고 발표하게 되어 기쁘군요
모두 맛있다|모든 게 맛있었습니다
모두 예전 비슷 없다|모든 게 예전 같지는 않은 거예요
모두 잘 되다 아마|모든 일이 잘될거예요
숨기다 없다 모두 솔직 이야기|모든일을 숨김없이 털어놓고 말해 봐요
모르다 아마|모르시겠어요
모임 무엇|모임은 어땠어요
목적 곳 어디|목적지가 어디신가요
목적 곳 어디|목적지가 어디죠
모르다|몰랐습니다
몸무게 얼마|몸무게가 얼마나 나가세요
몸살 있다|몸살이 있습니다
매우 싸다|몹시 싸다
못하다 없다|못하는 게 없으시군요
이야기 근거 무엇|무슨 근거로 그렇게 얘기하지
뜻 무엇|무슨 뜻입니까
말 의미 무엇|무슨 말을 하려는 거죠
문제 무엇|무슨 문제요
잘못 무엇|무슨 일이 잘못됐니
한국 음식 먹다 종류 무엇|무슨 종류의 한국 음식을 드시겠어요
전화 무엇|무슨일로 전화하셨습니까
일 발생 무엇|무슨일이 생겼습니다
먹다 무엇 원하다 질문|무얼 먹었으면 좋겠어요
전공 무엇|무얼 전공하십니까
무엇 때문 바쁘다 질문|무엇 때문에 그렇게 바빴어요
듣다 무엇|무엇을 듣고 계십니까
불평 무엇|무엇을 불평하고 계십니까
문 열다 부탁|문 좀 열어 주시겠어요
문 잠기다 무엇|문을 잠글까요
문 잠기다 때문 차 들어가다 못하다|문이 잠겨서 차안에 들어갈 수 없었어요
물론 확실|물론 확실합니다
물론 기꺼이 하다|물론 기꺼이 그렇게 하겠습니다
물 충분|물이면 되겠어요
사소하다 화나다 왜|뭐 그런 것 가지고 화를 내세요
아무것 말하다 해보다|뭐든지 말씀만 해 보십시오
이야기 무엇|뭐라고 하셨죠
돕다 무엇|뭐좀 도와 드릴까요
괜찮다|뭘요 괜찮습니다
미국 곳 당신 목적지 어디|미국에서 당신의 목적지는 어디입니까
지불 미리|미리 지불하셔야 합니다
미안하다 하지만 가장 가깝다 지하철 곳 어디|미안하지만 가장 가까운 지하철역이 어디에 있습니까
미안하다 하지만 그 말 이야기 필요 없다|미안합니다만 그 말은 주제를 벗어난 이야기입니다
미안하다 하지만 월급 대하다 이야기 원하다 없다|미안합니다만 월급에 대해선 얘기하고 싶지 않습니다
미안하다 하지만 안되다|미안합니다만 안됩니다
미안하다 하지만 알다 방법 없다|미안합니다만 알 길이 없군요
미안하다 하지만 나 없다|미안합니다만 제게 없는데요
미안하다 하지만 지금 회의 중|미안합니다만 지금 회의 중이신데요
밖 날씨 영하|바깥기온이 영하로 떨어졌겠는데요
밖 날씨 무엇|바깥날씨가 어떻습니까
바람 때문 춥다|바람 때문에 그렇게 추운 것같습니다
바로 요점 이야기|바로 요점만 말씀드리겠습니다
박물관 가다 길 가르치다 달라다 부탁|박물관으로 가는 길 좀 가르쳐 주세요
반드시 필요 없다|반드시 그럴 필요는 없어요
반드시 아니다|반드시 그렇지는 않아요
인정 낫다|받아들이는 것이 유리할 겁니다
방금 전화 잘모|방금 건 전화는 잘못 걸린 전화였습니다
방문 목적 무엇|방문 목적은 무엇입니까
방 깨끗 치우다 부탁|방을 깨끗이 치워
방 정리 부착|방을 정돈해 주세요
방 하나 있다 무엇|방하나 있습니까
방해 아마 염려|방해가 되지 않을지 모르겠군요
방해 있다 무엇|방해가 되지 않겠습니까
방해 하지마|방해하지 마세요
배 부르다 하지만 말 듣다 때문 먹다 해보다|배가 부르지만 그 말씀을 들으니 안 먹고 지나칠 수가 없네요
배달 있다 무엇|배달해 줍니까
배 타다 멀미|배를 타면 멀미를 해요
버스 요금 얼마|버스 요금은 얼마입니까
버지니아 지역 여행 무엇|버지니아 여행은 어땠습니까?
벽 불 굉장하다|벽난로가 굉장하군요
화장지 때문 변기 막히다|변기가 화장지로 막혔군요
특별 문제 없다 무엇|별고 없으십니까
병원 어디|병원이 어디죠
생각 보다 어렵다 아니다|보기보다 어렵지 않아요
보답 원하다|보답해 드릴 수 있었으면 좋겠어요
계속 보다 마음 들다|보면 볼수록 마음에 드네요
보다 못하다|보지 못합니다
보통 때 시간 얼마|보통때는 시간이 얼마나 걸리나
보통 때 같다 시간 출발 하지만 여기 곳 까지 시간 2시간 정도|보통때와 같은 시각에 집을 떠났는데 여기까지 2시간이나 걸렸어요
보험 가입 무엇|보험에 드시겠어요
분명 다르다 사람 나 혼동|분명히 저를 다른 사람과 혼동하셨습니다
 불 앞 서다 몸 따뜻|불 앞에서 몸을 좀 녹이세요
불 빌리다 부탁|불 좀 빌려 주시겠어요 
불 키다 그대로 가다 하지마|불을 켠 채 떠나지 마라
비 오다 아마|비가 올것 같나요
비밀|비밀로 해 두세요
비밀 이야기 하지마|비밀을 누설하지 마세요
 비 오다 날 좋다 무엇|비오는 날을 좋아하세요
비행 때 저녁 식사 있디 무엇|비행 중에 저녁식사가 나옵니까
가다 때 비행기 무엇|비행기로 가시나요
비행기 타가 필요|비행기를 타야 하는데요
빌 무엇|빌은 어떻게 됐어요
비 오다 때 걷다 좋다|빗속을 거닐기를 좋아하세요
빚 없다 살다 어렵다|빚 안지고 살아나가기가 어려워지고 있습니다
빠르다 좋다|빠르면 빠를수록 좋다
빨갛다 구두 파랗다 구두 둘 중 좋다 무엇|빨간 구두와 파란 구두 중 어느것이 좋을지 모르겠어요
빠르다 가다|빨리 갑시다
빵 만 먹다 하지마|빵만 너무 먹지 마세요
나 사과 파이 좋다 알다 방법 무엇|사과 파이를 제가 좋아하는 것을 어떻게 아셨지요
사람 많다 때문 안되다|사람 눈이 많아 안 돼요
사람 말 있다|사람들이 하는 말이 있죠
사람 겉 모습 보다 알다 어렵다|사람은 겉보기로는 알 수 없어요
사실 지금 시작|사실은 이제 막 시작했습니다
사실|사실이라니까요
사업 잘하다 무엇|사업은 잘 되십니까
사전 찾다 해보다|사전을 찾아보세요
4주 동안 휴가|사주간 휴가 입니다
사진보다 실물 더 예쁘다|사진보다 실물이 더 예쁘네요
그녀 실물 보다 사진 더 예쁘다|사진은 그녀의 실물보다 더 잘 나왔군요
산책 때 개 함께 가다 부탁|산책 갈 때 개도 데리고 가세요
3일 밤 자다 이후 토요일 오전 나가다|삼일 밤을 지내고 토요일 오전에 나가려고요
상관 없다|상관 없어요
비슷 맞다|상당히 비슷하게 맞혔습니다
상대 사람 입장 생각하다 면 이해 가능|상대편의 입장에서 보면 그것이 이해가 될거예요
영화 시간 언제|상영시간이 어떻게 되죠
상의 원하다 있다|상의 드리고 싶은 게 있어서요
셔츠 새롭다 입다 모습 좋다|새 셔츠를 입으니 보기가 좋군요
직업 새롭다 마음 들다 무엇|새 직업은 마음에 드세요
차 새롭다 사다 보다 무닷|새로 산 내 차는 또 어떤 것 같아요
새롭다 태어나다 느끼다|새로 태어난 기분입니다
색 모양 마음 들다 않다|색깔이나 모양이 맘에 들지 않습니다
생각 있다 무엇|생각나는 게 있으세요
생각 없다|생각이 얼른 떠오르지 않아요
생물 선생님 누구|생물 선생은 누구로 했니
서류 조사 이후 잘못 있다 돈 빼다|서류를 조사해 봐서 잘못 되었으면 그 요금을 빼드리지요
주저 하지마 이야기 부탁|서슴치 말고 하세요
서울 곳 서울 타워 유명|서울은 서울 타워로 유명합니다
선생님 발견 잡히다 면 상황 곤란|선생님한테 잡히면 곤란해해질 걸
선생|선생이예요
성함 전화번호 무엇|성함과 전화번호가 어떻게 되세요
성함 듣다 확실 아직|성함을 확실히 듣지 못했습니다
성함 무엇|성함이 어떻게 되시죠
세차 원하다|세차를 원하세요
소년 시절 때 어머니 매우 소중|소년 시절에 어머닌 내게 무척 조중한 존재였어요
소문 듣다 끝|소문으로 들었어요
손가락 반창고 붙이다 부탁|손가락에 반창고 좀 붙여 주시겠습니까
솔직 이야기 돈 하나도 없다|솔직하게 말해 오늘은 돈이 한푼도 없어요
공연 시작 언제|쇼는 언제 시작하죠
수고 아마 하지만 나 아기 대신 보호 부탁|수고스럽지만 내가 없는동안 내 아이를 돌봐 주세요
하나 질문|수수께끼 하나 물어 볼까
수업 빠지다 안되다|수업을 빼먹지 말아야 한다
알다|알아요
술 내리다 이후 다시 이야기|술 깬 다음에 우리 얘기합시다
어디 곳 남쪽|어느 쪽이 남쪽이죠
춥다|쌀쌀 해요
프로그램 좋다 무엇|어느 프로그램을 가장 좋아합니까
알다|알겠습니다
이거 방법 무엇|어걸 어떻게 하면 될까요
시험 목적 해보다|시험삼아 한번 해 봅시다
이거 생각 무엇|어걸 어떻다고 생각하세요
일 어디|어디서 근무하세요
아직 멀다|아직 멀었어요
아르바이트 중 무엇|아르바이트를 하고 있나요
시간 빼앗다 죄송하다|시간을 너무 많이 빼앗아 죄송합니다
신호 없다|신호가 안 떨어집니다
아프다 어디|어디가 아파요
아이 귀엽다|아이가 참 귀엽군요 
점수 6대6 비기다|스코어는 6:6으로 비겼어요
어디 곳 이야기 모르다|어디를 말씀하시는지 모르겠습니다
미안하다 하지만 가다 어디|실례지만 어디에 가시는지요
내리다 어디|어디서 내려 드릴까요
보다 없다 마음 떠나다|안보면 마음조차 멀어진다
전화 아무것 없다|아무도 전화를 안 받네요
무엇|어때
아무것 상관 없다|아무거나 상관없습니다
쓸데 없다 일 참견 하지마|쓸데없는 일에 참견 말라구
아스피린 먹다 해보다|아스피린을 한번 드셔 보세요
알다|알았어요
아무것 상관 없다|어느 쪽이든 좋아요
아무것 이야기 안하다 약속 부탁|아무한테도 말하지 않는다고 약속해 줘요
시간 흐르다 알다 되다|시간이 지나면 알게 돼요
쓸데 없다 행동 하지마|쓸데없는 짓 말아요
악기 사용 가능 무엇|악기 다룰 줄 아세요
오다 어디|어디서 오셨읍니까
식사 이야기 계속 가능 무엇|식사하며 이야기를 나눌 수 있을까요
아무것 이야기 하지마|아무에게도 말하지 마세요
시골 곳 차 운전 가다 무엇|시골로 드라이브가는 것 어때요
시간 얼마|시간은 얼마나 걸릴까요
어디 도로 가다 필요 이야기 부탁|어느 도로를 따라가야 하는지 이 지도를 보고좀 가르쳐 주세요
거짓 아마|아마도 거짓말일걸요
기차 갈아타다 곳 어디|어디서 기차를 바꿔타야 합니까
신분증 보다 달라다|신분증 좀 보여 주실까요
약속 지키다 못하다 용서 부탁|약속을 지키지 못한 걸 용서해 주세요
가다 어디|어디 가십니까
버스 타다 무엇|어느 버스를 타야 하죠
사이즈 얼마|사이즈가 얼마입니까
약속 취소 가능 무엇|약속을 취소해도 될까요
아버지 나 음악 보다 곳 인도|아버지께서 저를 음악회에 데리고 가셨었어요
실수 두렵다 하지마|실수를 할까봐 두려워 마세요
시간 흐르다 알다 되다|시간이 흐르면 알게 될 거예요
학교 어디|어느 학교를 나오셨습니까
알다 있다|알고 있어요
공연 어디|어디서 공연하지요
승리 우리|승리는 우리의 것입니다
신체 좋다|신체가 좋습니다
얘기 계속 부탁|얘기 계속해 주시죠
결정 아직|아직 결정되지 않았습니다
아이 불 가깝다 다가가다 못하다 막다|아이들이 불 가까이 가지 못하게 하세요
신호등 지나다 바로 있다|신호등을 지나면 바로 있습니다
시험 결과 무엇|시험결과는 어떻게 되었나요
대학 어디|어느 대학에 다니십니까
승차 부탁|승차하십시오
약 7년|약 7년요
숨다 찾다 놀다 하다|숨바꼭질하자
시험 결고 ㅏ무엇|시합 결과는 어떻게 되었나요
아침 휴식 시간 결정 있다 무엇|아침 휴식시간이 정해져 있나요
쉬다 시간 달라다|숨쉴 겨를을 주세요
당신 새롭다 자전거 가지다|아주 새 자전거를 가지셨군요
야구 관람 즐기다 해보다|야구관람을 즐겨하세요
학생 아르바이트 많다|아르바이트하는 학생들이 많아요
두통 심하다 있다|심한 두통이 있어요
결정 아직|아직 결정을 못 했어요
아주 좋다|아주 좋았어요
아니다 괜찮다|아니 괜찮아요
좋다 아니다|안 좋아요
매우 잘하다|아주 잘 하고 있어요
복수 당연하다|앙갚음을 하는 것은 당연하죠
식사 잘하다 맞추다 무엇|식사가 구미에 맞으셨나요
사용 가능 아마|쓸 만해 보이는데요
사실 그 사람 어제 기차 곳 만나다|실은 어제 그사람을 기차에서 만났습니다
안색 형편없다|안색이 형편없군요
학교 어디 다니다 질문|어느 학교에 다니십니까
어디 곳 가다 저녁 먹다 함께|어디 가서 저녁이나 함께 합시다
순서 그대로 이야기|순서대로 얘기합시다[여행 하루] 전통 가득 전주 아이 보호 여행|[데이투어] 전통이 가득한 전주 아이 돌봄 여행
출발지 기타|출발지 기타
진행 시간 당일여행|진행 시간 당일 여행
활동 강도 활발|활동 강도 활발
포함 사항 교통/기사, 식사, 티켓, 가이드,기타 서비스|포함 사항 교통/기사, 식사, 티켓, 가이드, 기타 서비스
예전 모습 그대로 전주 한옥 마을 여행 하루|옛 모습 그대로를 담은 전주 한옥 마을 데이 투어
전통 가득 전주 아이 보호 여행|전통이 가득한 전주 아이 돌봄 여행
전통 한옥 수 700채 국내 가장 넓다 한옥 마을 곳|700여 채의 한옥이 군락을 이루고 있는 국내 최대 규모의 전통 한옥촌!
우리 예전 모습 보다 가능 곳 전주 한옥 마을 출발|우리의 옛 모습을 가장 잘 보여줄 수 있는 그곳, 전주 한옥 마을로 다함께 출발!
[어뮤즈 아이 보호 여행] 특별 돕다 5가지|[어뮤즈 아이 돌봄 여행]만의 5가지 특정 서비스
1. 다르다 곳 다르다 각자 맞추다 돕다|1. 차별화된 맞춤 서비스
사람 각자 상황 또 원 맞추다 돕다|고객 별 상황 및 니즈에 맞는 개별 맞춤 서비스
알러지 또 사람 각자 안 맞추다 음식 확인 후 간식 또 식사 제공|알러지 등 고객 특이 사항 체크 후, 간식 및 식사 제공
2. 동시 2곳 여행 진행|2. 동시에 2코스 진행
가족 각자 다르다 여행 구경 결국 사람 만족 크다 또 시간 절약|가족 구성원 별 일정을 나누어 고객 만족UP & 시간 활용UP
3. 인솔 사람 전문 믿음 가능|3. 믿음직한 전문 인솔자
운전, 인솔, 스냅 사진 촬영, 일 사람 1명 붙다 가다|운전, 인솔, 스냅 사진촬영, 내부 직원 최소 1인 동행
4. 보호 서비스|4. 돌봄 서비스
어린이, 노인 포함 가족 모두 여행 즐기다|어린이, 노인 동반 가족 구성원 모두가 즐거운 여행
안전캠 기록, 있다 곳 어디 계속 확인 또 연락|안전캠 기록, 실시간 위치 추적 & 연락
5. 전용 차 돕다 타다|5. 프라이빗 픽업 서비스
집 앞 차 돕다 타다|집 앞 픽업 서비스
차 독하다 약 뿌리다 깨끗 코로나 걱정 불필요|코로나 걱정 없이 철저한 소독 후, 차량 이용
어뮤즈 아이 보호 여행 독특 이유|어뮤즈 아이 돌봄 여행과 함께하면 다른 이유!
여행 때 아이 부모 각자 맞추다 여행 모두 즐기다 가능|여행 중에 아이와 보호자 모두가 즐길 수 있는 맞춤형 코스 진행
공통 코스. 어린이 코스 등 투어뮤즈 사진 찍다 곳 사진|공통코스, 어린이코스 등 투어뮤즈가 포토스팟에서 다양한 사진을 남겨줘요.
과거 전통 여러가지 직접 경험 가능|각종 전통적인 체험들을 통해 과거 우리의 것을 체험해 봐요.
기본 옵션|기본 옵션
어린이 평일/주말 1인당 121,000원|어린이 평일/주말 1인당 121,000원
어른 평일/주말 1인당 108,000원|어른 평일/주말 1인당 108,000원
포함 사항|포함 사항
현지 인솔, 아이 보호 돕다, 입장 및 체험 돈, 점심 1회, 여행 사람 보험|현지 인솔, 아이 돌봄 서비스, 입장 및 체험비, 중식 1회, 여행자 보험
불포함 사항|불포함 사항
차 돕다 타다 / 차 돕다 내리다, 기타 개인 경비|픽업/드롭오프, 기타 개인 경비
여행 인원|여행 인원
최소 출발 인원 4인 (최대 6인)|최소 출발 인원 4인 (최대 6인)
어린이 안전 위하다 예약 가능 사람 수 4명|어린이는 안전을 위해 최대 4명까지 예약 가능
선택 옵션|선택옵션
차 돕다 타다  9인승 차량 121,000원|픽업 서비스 :9인승 차량 121,000원
기준 서울/경기 곳 출발|서울/경기 출발 기준
전주 한옥 마을 제대로 즐기다|전주 한옥마을 제대로 즐기기
어른 코스 차 돕다 타다 → 점심 식사 → 한복 체험 → 전통술 박물관 → 독랑원 → 해산|어른코스 픽업 → 점심식사 → 한복체험 → 전통술 박물관 → 독랑원 → 해산
어린이 코스 차 돕다 타다  → 점심식사 → 한복체험 → 승광재 → 향교길도자기 → 해산|어린이코스 픽업 → 점심식사 → 한복체험 → 승광재 → 향교길도자기 → 해산
상황 따르다 계획 변경 있다 아마|상기 일정은 현지 사정에 따라 변동될 수 있습니다.
한복 마을 한복 체험|한복마을 한복체험
전통 한옥 마을|전통이 살아 숨 쉬는 한옥 마을
예쁜 한복 입다 전통 가옥 걷다 가족 함께 사진 찍다 추억 가능|전통 가옥 사이를 예쁜 한옥을 입고 걸어보아요. 가족들과 함께 예쁜 사진과 추억도 만들 수 있어요.
거리 다양 음식 맛있다|거리에 맛있는 음식도 가득해 다양한 음식을 맛보는 재미가 솔솔~
승광재|승광재
한국 전통 아름답다 있다 황손 집|한국적인 아름다움을 담은 황손의 집
대한 황실 마지막 황손 이름 이석 살다 곳 전통|대한 황실의 마지막 황손 이석이 살고 있는 곳!
전통 염색 체험 또 떡 메치기 체험 가능|전통 염색 체험과 떡 메치기 체험을 하며 오감을 일깨워봐요~
황교길 도자기 체험|황교길 도자기 체험
세상 특별 하나 컵 직접 만들다|세상에 하나 뿐인 나만의 컵 만들기
손물레 사용, 한 단 한 단 흙 쌓다 만들다 다음 안료 이용 그림 그리다 또 흙 장식|손물레를 이용, 한 단 한 단 흙을 쌓아 올려 만든 다음, 안료를 이용하여 그림을 그리고 흙으로 장식합니다.
도자기 만들다 끝 이후 2번 굽다 각자 집 배송|완성된 작품은 초벌과 재벌 후에 댁으로 배송해 드려요~
전통 술 박물관|전통 술 박물관
우리 전통 술 체험 곳|우리의 전통 술 체험공간
전국 각 지역 전통 술 구경 또 술 역사 배우다 가능 박물관|전국 각 지역의 전통주를 알아보고 술의 역사를 알아볼 수 있는 박물관입니다.
술 만들다 방법 전통 술 발전 역사 배우다 가능 또 전통 술 마시다 가능 곳|술을 만드는 절차 및 전통 술의 발전사도 알 수 있고 전통주를 시음해 볼 수도 있는 알찬 장소입니다.
동락원|동락원
100년 오래 한옥 호텔|100년 된 고택의 한옥 호텔
한옥 마을 가장 유명하다 곳 전통 한옥 직접 체험 가능|전통 한옥을 직접 체험해 볼 수 있는 한옥 마을의 대표적 명소
공간 분리 곳 노천 족욕 또 커피 마시다 쉬다 후 한옥 마을 산책 가능|노천 족욕 카페에서 프라이빗하게 족욕 및 차 한잔의 여유를 즐긴 뒤 한옥 마을을 산책해 보세요.
일정|일정
전주 소리 문화 구경 곳 앞 모이다|전주 소리 문화관 앞 집결
오후 1:00 아마|오후 1:00 예정
보호 인도 사람 만나다 출발|돌봄 가이드를 만나 일정 시작
한옥 마을 한복 체험|한옥마을 한복체험
1시간 30분 아마|1시간 30분 소요 예정
전통 직접 경험 가능 곳|전통이 살아 숨 쉬는 공간
승광재|승광재
2시간 아마|2시간 소요 예정
한국 전통 아름답다 반영 황손 집|한국적인 미를 담은 황손의 집
향교길 도자기|향교길 도자기
1시간 아마|1시간 소요 예정
본인 얼굴 모양 비슷 도자기 만들다 체험|자화상 도자기 만들기 체험
구경 여행 끝 이후 해산|투어 종료 및 해산
오후 6:00 끝 아마|오후 6:00 예정
여행 끝 이후, 부모님 만나다 인원 확인 후 해산|투어가 종료된 후, 부모님을 만나 인원 체크 후 해산
포함사항|포함사항
교통/기사|교통/기사
승합차|승합차
식사|식사
여행 지역 곳 방식 음식|현지식 (전일정)
티켓|티켓
체험 돈 전체 포함|체험비 전체 포함
인도 사람|가이드
일반 인도 사람 동행 (부분 일정), 운전 인도 사람 동행 (부분 일정)|일반 가이드 동행 (부분일정), 드라이빙 가이드 동행 (부분일정)
기타 돕다|기타서비스
여행 사람 보험|여행자보험
유의 사항|유의사항
모두 돕다|컨시어지 서비스
차 돕다 타다, 인원 추가, 숙박 등 개인 맞추다 돕다 제공|픽업, 인원 추가, 숙박 등의 개인 맞춤형 서비스를 제공합니다.
문의 사람 상황 또 원 따라 포함 사항 포함 없다 사항 변경 가능|문의해 주시는 고객의 상황과 요구 사항에 따라 포함 사항 및 불포함 사항은 변경될 수 있으며,
원인 최종 견적금 변경 아마|이로 인해 최종 견적금의 차이가 발생될 수 있습니다.
기본 보다 더 원 사람 문의 부탁|기존 상품에 추가적인 옵션을 희망하는 분께서는 별도로 문의해 주시길 바랍니다.
여행 사람 보험|여행자 보험
여행 때 사고 대비 여행 사람 모두 여행 관련하다 보험 대신 신청 있다|여행 시 발생할 수 있는 여러 사고에 대비하여 여행 참가자 전원의 여행자 보험 가입을 대행해 드리고 있습니다.
보험금 청구 또 보상 무엇 하나 손해 보험|보험금 청구 및 보상은 하나손해보험에서 이루어집니다.
보험비 여행 비용 포함 있다 보험 가입 위하다 개인 정보 이용 가입 끝 이후 바로 삭제|보험비는 투어 비용에 포함되어 있으며, 보험 가입을 위해 수집한 개인정보는 가입 완료 후 즉시 폐기됩니다.
키코 GPS 추적기|키코 GPS 추적기
모든 아동 안전 목적 기계 부착 있다|안전을 위해 모든 아동들은 해당 기기를 부착하게 됩니다.
보호 사람 관련하다 애플리케이션 다운 받다 아이 어디 곳 확인 가능|보호자들도 해당 기기의 애플리케이션을 설치하여 아이의 위치를 파악할 수 있습니다.
영상 촬영 동의|영상 촬영 동의
갑자기 발생 상황 해결 위하다 여행 모습 모두 녹화 있다|돌발 상황에 대처하기 위해 투어의 전과정은 카메라로 녹화 되고,
부모 아동 얼굴 녹화 동의서 작성 있다|아동의 초상권에 대한 보호자의 동의서를 받을 예정입니다.
여행 내용 기록 동의서 작성 꼭 필요 하지만 정보 이용 원하다 원하지 않다 선택 가능하다|투어 내용 기록을 위한 동의서는 필수 사항이며, 이를 마케팅에 활용함에 대한 동의는 선택 사항입니다.
장애인 별도 문의|장애인 이용객 별도 문의
저희 장애인 여행 사람 위하다 풀 컨시어지 여행 기획 회사|저희는 장애인 여행자들에게 풀컨시어지 여행을 기획해드리는 회사입니다.
비 장애인 전용 때문 개인 장애 유형 또 등급 따르다 일정 변경 어렵다|해당 상품은 비장애인을 대상으로 한 고정 상품으로, 개개인의 장애 유형과 정도를 고려한 일정 변경이 어렵습니다.
설명 그대로 여행 원하다 사람 개인 문의 부탁|위의 구성으로 여행을 희망하시는 분께서는 별도로 문의해주시길 바랍니다.
담당자|담당자
부장 김찬중|부장 김찬중
어린이 보호 여행 창의력 향상 또 자아 탐색 돕다 있다|어린이 돌봄 여행 코스는 창의력 향상과 자아 탐색에 도움이 될 수 있도록 구성하였으며.
또 아이 보호 전문 사람 인솔|전문 돌봄이가 아이들을 인솔할 예정입니다.
한 어르신 보호 여행 활동 강도 힘들다 아니다 모두 여행 즐기다 가능|한 어르신 돌봄 여행 코스는 활동 강도가 높지 않아서 누구나 여행을 즐길 수 있도록 구성하였습니다.
상담 자세하다 원하다 사람 02-719-6811 연락 부탁|자세한 상담을 원하시는 분들은 02-719-6811으로 문의 바랍니다.
출발지 기타|출발지 기타
진행 시간 당일 여행|진행 시간 당일여행
활동 강도 낮음|활동 강도 낮음
제공 언어 한국어|제공 언어 한국어
포함 사항 교통/기사, 식사, 티켓, 인도 사람, 기타 돕다|포함사항 교통/기사, 식사, 티켓, 가이드, 기타서비스
전통 문화 현대 문화 함께 있다 안동 아이 보호 여행|전통문화와 현대문화가 공존하는 안동 아이돌봄 여행
선비 마을 곳 편한 걸어 다녀|선비마을에서 유유자적
안동 맥주 공장 하루 여행|안동 브루어리 데이투어
안동 과거 현재 모습 보다 가능 곳|과거와 현재가 공존하는 곳, 안동
전문 사람 함께 우리 나라 전통 음식 만들다|전문가와 함께 만드는 우리나라 전통 음식!
촉감 미감 즐기다 가능하다|촉감과 미감을 함께 즐겨보아요.
안동 수제 맥주 유명하다|안동이 수제 맥주로 유명하다는 사실 알고 계셨나요?
안동 하루 여행 때 맥주 공장 곳 만들다 구경 또 직접 마시다 즐기다 좋다|맥주 브루어리에서 양조과정을 직접 보고 시음까지 즐길 수 있는 안동 데이투어!
아이 전통 문화 체험 어른 한옥 곳 예전 현재 문화 즐기다 좋다|아이들은 전통문화를 체험하는 값진 경험을, 어른들은 한옥에서 뉴트로 문화를 즐기는 1타 2피 여행을 떠나 보세요.
안동 한국 전통 문화 체험 유명하다 곳|한국 전통 문화 체험의 성지, 안동!
전문 사람 함께 우리 나라 전통 음식 만들다 또 전통 하회탈 체험|전문가와 함께 만드는 우리나라 전통 음식, 전통 하회탈 체험까지
시원하다 맥주 마시다 기분 좋다 맛있다|시원한 생맥주로 맛과 감성을 한번에
아이 함께 맥주 공장 관람 어렵다|아이와 함께 가기 어려운 맥주 브루어리 투어
하지만 가족 함께 여행 즐기다 가능|가족 여행에서도 즐기자
여행 때 자유 시간 있다|여행 중에 즐기는 짜릿한 자유 시간
가족 여행 때 하루 절반 가족 분리 구경 가능|가족 여행 일정 중 반나절만 따로~
기본 선택|기본 옵션
어린이 평일/주말 1인당 117,000원|어린이 평일/주말 1인당 117,000원
어른 평일/주말 1인당 135,000원|어른 평일/주말 1인당 135,000원
포함 사항|포함 사항
여행 지역 곳 인솔, 아이 보호 돕다, 입장 및 체험비, 중식 1회, 여행 사람 보험|현지 인솔, 아이돌봄 서비스, 입장 및 체험비, 중식 1회, 여행자보험
불포함 사항|불포함 사항
서울/경기 차 돕다 타다 돈, 기타 개인 경비|서울/경기 픽업비, 기타 개인 경비
여행 인원|여행 인원
최소 출발 인원 4인 (최대 6인)|최소 출발 인원 4인 (최대 6인)
어린이 안전 위하다 예약 가능 사람 수 4명|어린이는 안전을 위해 최대 4명까지 예약 가능
자유 선택|선택 옵션
차 돕다 타다 9인승 차량 121,000원|픽업서비스 9인승 차량 121,000원
기준 서울/경기 곳 출발|서울/경기 출발 기준
1일차|1일차
브런치 시간 1시간 아마|브런치 타임 1시간 소요예정
한옥 카페 곳 브런치 즐기다|한옥 카페에서 즐겨보는 브런치
조용하다 쉬다 한옥 곳 먹다 무엇?|고즈넉한 한옥에서 브런치 어떠세요?
마음 편안하다 안전하다 곳 점심 맛있다 먹다 가능|마음을 편안하게 만들어 주는 가옥에서 분위기와 맛있는 점심 모두 챙겨가세요.
하회 세계 탈 박물관 구경 1시간 아마|하회 세계 탈  박물관 1시간 소요 예정
탈 개인 직접 만들다|내 손으로 직접 만들어 보는 나만의 탈!
아이 탈 직접 만들다 창의력 발전 돕다|탈 만들기 체험을 통해 아이들 창의력도 키우고,
우리 문화 또 역사 배우다 체험 가능|우리 문화와 역사에 한 발짝 더 가까워질 수 있는 일석이조 체험,
하회 세계 탈 박물관 체험 해보다|하회세계탈박물관에서 함께해요!
안동 맥주 만들다 곳 회사|안동 브루잉 컴퍼니
안동 맥주 만들다 곳|안동 맥주가 만들어지는 곳
안동 맥주 직접 만들다 유명 당신 알다 있다?|안동의 수제 맥주가 유명하다는 사실, 알고 계셨나요?
바로 맥주 만들다 시원하다 경험 사람 모두 좋다 곳|바로 만든 생맥주의 시원함을 아시는 분들이라면 놓칠 수 없는 장소
안동 시내 구경 30분 아마|안동 시내 투어 30분 소요 예정
지역 전문 인도 사람 함께 구경|전문 지역 가이드와 함께 둘러봐요.
안동 길 잘 알다 사람 함께 안동 도시 안 여행|안동을 누구보다 잘 아는 전문가이드와 함께하는 안동 시내투어.
안동 유명하다 곳 모두 구경 또 안동 역사 무엇 이야기 듣다 유익 크다 또 즐기다 좋다|안동의 명소들을 빼놓지 않고 구경해 보고 안동이 가진 역사 이야기도 들어볼 수 있는 유익하고 즐거운 시간을 보내세요!
예미정 1시간 30분 아마|예미정 1시간 30분 소요 예정
안동 지역 맏아들 후손 전통 있다 곳|안동의 종가 음식을 계승하는 곳
직접 전통 음식 만들다 먹다 배우다 가능|직접 만들어보고 시식하며 배워보는 전통음식!
전문 사람 직접 배우다 전통 음식 문화 이해 깨닫다 또 역사 훌륭하다 배우다 가능|전문가에게 배우며 전통음식 문화를 올바르게 이해하고 역사의 우수성도 함께 배울 수 있어요.
안동 맥주 사람 구경 가능 곳 1시간 아마|안동 맥주 퍼블릭 하우스 1시간 소요 예정
한옥 고치다 새롭다 짓다 술 마시다 곳|한옥을 개조한 펍
오래되다 건물 새롭다 짓다 안동 가장 인기 많다 곳|낡은 건물을 개조해 새롭게 태어난 안동 제일가는 핫 플레이스!
보통 생활 피곤 힘들다 맥주 마시다 힘|일상에서 쌓인 피로를 시원한 생맥주와 함께 이곳에서 날려보아요.
지역 상황 따르다 계획 변경 가능 아마|상기 일정은 현지 사정에 따라 변동될 수 있습니다.
안동역 앞 모이다|안동역 앞 집결
오후 1:00 모이다 아마|오후 1:00 예정
투어 뮤즈 만나다 출발 (안동 안 차 돕다 타다 곳 조율 가능)|투어뮤즈를 만나 일정시작 (안동 내에서 픽업 장소 조율 가능)
점심 식사|점심식사
1시간 아마|1시간 소요 예정
여행 지역 곳 방식 식사|현지식 식사
풍전 브런치 카페|풍전 브런치카페
1시간 아마|1시간 소요 예정
한옥 카페 곳 브런치 즐기다|한옥 카페에서 즐겨보는 브런치
하회 세계 탈 박물관|하회세계탈박물관
1시간 아마|1시간 소요 예정
탈 개인 직접 만들다|내 손으로 직접 만들어 보는 나만의 탈
예미정|예미정
1시간 30분 아마|1시간 30분 소요 예정
안동 맏아들 후손 집 곳 전통 음식 먹다|안동 종가 음식을 계승하는 곳
안동역 곳 해산|안동역 앞 해산
오후 6:00 아마|오후 6:00 예정
구경 여행 끝나다 이후, 부모님 만나다 사람 수 확인 후 해산|투어가 종료된 후, 부모님을 만나 인원 체크 후 해산
청정한 숲과 문화가 있는 낙원, 남이섬|청정한 숲과 문화가 있는 낙원, 남이섬
나미나라 공화국 (Naminara Repubic)을 들어보셨나요?|나미나라 공화국 (Naminara Repubic)을 들어보셨나요?
강원도 춘천에 있는 남이섬은 전세계 관광객들에게|강원도 춘천에 있는 남이섬은 전세계 관광객들에게
아름다운 동화와 노래를 선물하는 이 세상에 유일무이한 상상공화국입니다.|아름다운 동화와 노래를 선물하는 이 세상에 유일무이한 상상공화국입니다.
”겨울 연가”의 촬영지로도 유명하죠!|”겨울 연가”의 촬영지로도 유명하죠!
청정한 숲과 아름다움 강, 매혹적인 문화가 어우러진 낙원으로 초대합니다.|청정한 숲과 아름다움 강, 매혹적인 문화가 어우러진 낙원으로 초대합니다.
맑은 공기를 마시며 아이들과 따로 또 함께하는 여행을 떠나보세요.|맑은 공기를 마시며 아이들과 따로 또 함께하는 여행을 떠나보세요.
기본옵션|기본옵션
어린이 평일/주말 1인당 91,000원|어린이 평일/주말 1인당 91,000원
어른 평일/주말 1인당 103,000원|어른 평일/주말 1인당 103,000원
깡타 먹이주기 30분 소요 예정|깡타 먹이주기 30분 소요 예정
말썽꾸러기 타조|말썽꾸러기 타조
숲 속 놀이터에서 뛰어놀기|숲 속 놀이터에서 뛰어놀기
자연을 이용하여 만든 친환경 놀이 시설|자연을 이용하여 만든 친환경 놀이 시설
그림책 놀이터 구경하기|그림책 놀이터 구경하기
세계 각국의 그림책을 한 곳에서!|세계 각국의 그림책을 한 곳에서!
유니세프 나눔열차 탑승하기 20분 소요 예정|유니세프 나눔열차 탑승하기 20분 소요 예정
선착장부터 섬 중앙까지 경치를 감상하며|선착장부터 섬 중앙까지 경치를 감상하며
스토리 투어 버스 탑승하기 20분 소요 예정|스토리 투어 버스 탑승하기 20분 소요 예정
해설사의 설명을 들으며 남이섬 한 바퀴|해설사의 설명을 들으며 남이섬 한 바퀴
자유 시간 즐기기|자유 시간 즐기기
자연 속에서 조용하게|자연 속에서 조용하게
픽업 장소 집결 및 안내|픽업 장소 집결 및 안내
장소에 따라 시간 상이|장소에 따라 시간 상이
픽업 장소 앞 집결 후 춘천 출발|픽업 장소 앞 집결 후 춘천 출발
포인트|포인트
아이에게 미연의 사고를 방지하기 위한 키코(KEYCO) 미아 방지 위치 추적기 부착|아이에게 미연의 사고를 방지하기 위한 키코(KEYCO) 미아 방지 위치 추적기 부착
점심 식사|점심 식사
남이섬 내 식당에서 식사|남이섬 내 식당에서 식사
남이섬|남이섬
3시간 소요 예정|3시간 소요 예정
타조 먹이 주기 체험, 숲 속 놀이터, 그림책 놀이터, 유니세프 나눔 열차 탑승|타조 먹이 주기 체험, 숲 속 놀이터, 그림책 놀이터, 유니세프 나눔 열차 탑승
포인트|포인트
여름에는 손 선풍기, 겨울에는 담요& 손난로 제공|여름에는 손 선풍기, 겨울에는 담요& 손난로 제공
인원 체크 후 집으로 출발|인원 체크 후 집으로 출발
오후 5시 예정|오후 5시 예정
인원 체크 및 건강 점검 후 귀가|인원 체크 및 건강 점검 후 귀가
직접 걷다|이번엔 걸어서 만나보세요!
제주도 동부 하루 여행|제주도 동부 데이투어
제주 동부 곳 하루 여행|일정 중 하루, 제주도 동부 투어
간단 짧다 무엇 날 여유롭다 길다|가볍고 짧게, 때로는 여유롭고 길게!
제주도 항상 가다 원하다|언제나 어떻게든 떠나고 싶은 마음의 고향, 제주도!
어뮤즈트래블 여행 때 하루 편안하다 쉬다 제주도 구경 날 준비 있다|여정 중 하루는 어뮤즈트래블이 준비한 힐링 코스로 제주의 매력을 한껏 느껴보세요.
어른 아이 따로 또 함께 구경 가능 제주도 동부 지역 방문 꼭 필요|어른과 아이가 따로 또 같이 하는 코스로, 제주도 동부의 필수 관광지 뿐 아니라
구경 곳 또 여유 걷다 구경 가능 곳 모두 있다 즐기다 좋다|여유롭게 걸어서 즐길 수 있는 장소까지 모두 포함된 알찬 일정~
지금 바로 여행 부탁|지금 바로 만나보세요~
같다 가다 하지만 따로 여행|같이 가지만 따로 즐기는 여행~
아이 어른 분리 여행 마음 든다 즐기다 가능|아이는 아이대로, 어른은 어른대로 각자 원하는 여행을 즐겨요
보통 택시 여행 아니다 돕다 많다|그냥 택시투어? NO! 풀 서비스 제공
운전 설명 알려주다 인솔 아이 보호 돕다|드라이빙 가이드, 인솔, 아이돌봄 서비스까지!
제주도 여행 때 하루 편안하다 즐기다 가능|제주도 여행 중 하루를 편안하게 즐겨보세요.
대표 유명 여행 곳 함께 구경|대표 관광지는 공통코스로!
섭지코지, 광치기 바다 곳 가족 사진 찍다 추억|섭지코지, 광치기 해변에서 가족 앨범에 추가될 멋진 사진을 찍어드립니다.
기본 선택|기본 옵션
어린이 평일/주말 1인당 106,000원|어린이 평일/주말 1인당 106,000원
어른 평일/주말 1인당 120,000원|어른 평일/주말 1인당 120,000원
불포함 사항|불포함 사항
제주도 왕복 항공권|제주도 왕복 항공권
포함사항|포함 사항
부가세|부가세
입장 및 체험비|입장 및 체험비
아동 간식비|아동간식비
섭지코지 1시간 소요 예정|섭지코지 1시간 소요 예정
제주 어울리다 곳|가장 제주다운 곳
제주도 곳 코 끝 모습 이름 부르다 코지|제주도에서는 코의 끝 모양으로 비죽 튀어나온 모습을 ‘코지’라고 하는데요,
섭지코지 곳 이름 보다 모습 무엇 추리 가능하다 제주도 곳 가장 아름답다 곳|이름에서 그 생김새를 유추할 수 있는 섭지코지! 제주도에서 가장 제주다운 곳이라고 해요.
유채꽃 피다 때 유채꽃 밝다 해 파랗다 바다 함께 구경 아름답다|유채꽃이 피는 계절이면, 유채꽃, 밝은햇살, 푸른 바다가 함께 어울려 아름다운 풍경을 만나볼 수 있어요.
조랑말 체험 공원 1시간 30분 아마|조랑말 체험공원 1시간 30분 소요 예정
초원 달리다 말 함께|초원을 달리는 말들과 함께
넓다 초원 곳 있다 승마 곳 자유 느끼다|드넓게 펼쳐진 초원에 위치한 승마장에서 만끽하는 자유!
풀 먹다 말 교감 또 제주 곳 말 환경 보다 재미있다 이해하다 쉽다 구경 체험 가능|유유히 풀을 뜯는 말들과 교감하며 제주의 말 생태를 쉽고 재미있게 이해하고 체험해 볼 수 있어요.
음식 주다 체험 또 승마 체험 가능|먹이 주기 체험과 승마 체험도 해볼 수 있답니다.
성산일출봉 1시간 30분 아마|성산일출봉 1시간 30분 소요 예정
바다 위 궁전|바다 위의 궁전
성산일출봉 유네스코 세계자연유산 등록|유네스코 세계자연유산에 등재된 아름다운 성산일출봉!
서쪽 육지 연결 외 3 곳 바다 절벽|육지와 연결된 서쪽을 제외한 3면이 해안 절벽입니다.
성산일출봉 예전 적 군대 막다 위하다 곳|예로부터 적군 공격을 방어하기 위해 요새로 사용되었던
일제강점기 경험 역사 슬프다 고통 있다 곳|성산일출봉은 일제강점기를 겪은 아픈 역사가 있는 곳이기도 합니다.
성산일출봉 곳 시간 여유 늦다 구경 역사 생각|시간을 가지고 천천히 둘러보며 성산일출봉의 지나간 역사를 떠올려봐요.
티타임 1시간 아마|티타임 1시간 소요예정
성산일출봉 곳 쉬다 시간 여유|성산일출봉을 바라보며 갖는 여유로움
성산일출봉 멋있다 구경 가능 카페 곳 커피 마시다 가능|성산일출봉의 경관을 한눈에 볼 수 있는 카페에서 향긋한 커피 한 잔을 즐겨 보세요.
산 오르다 이후 모습 크다 멋지다 구경 보다|등반 후, 다시 바라보는 크고 웅장한 모습의 성산일출봉!
오르기 이전 이후 모습 보다 기분 다르다 느끼다 가능|오르기 전과는 또 다른 기분을 느끼실 수 있습니다.
광치기 해변 30분 아마|광치기해변 30분 소요 예정
파랗다 바다 또 하늘|푸른 바다와 하늘
제주도 광치기 해변 곳 땅 모습 독특하다 이끼 많다 모습 신기하다|독특한 지형을 가져, 이끼가 가득 끼어 있는 모습이 신비로움을 자아내는 제주 광치기해변!
성산일출봉 배경 있다 또 파랗다 바다 또 파랗다 하늘 어울리다 아름답다|성산일출봉을 배경으로 푸른 바다와 푸른 하늘이 잘 어우러져 아름다움을 자아내는
곳 제주 바람 즐기다 해보다|이곳에서 제주의 바람을 온몸으로 느껴보세요.
차 돕다 타다 가다|픽업 및 이동
오전 9:00 아마|오전 9:00 예정
제주도 국제 공항 곳 차 돕다 타다|제주국제공항에서 픽업
섭지 코지|섭지코지
1시간 아마|1시간 소요 예정
제주도 어울리다 곳|가장 제주다운 곳
점심 식사|점심식사
1시간  예정|1시간 소요 예정
여행 지역 곳 방식 식사|현지식 식사
조랑말 체험 공원|조랑말 체험공원
1시간 30분 아마|1시간 30분 소요 예정
초원 달리다|초원을 달리는
광치기 해변|광치기 해변
30분 아마|30분 소요 예정
파랗다 바다 또 파랗다 하늘|푸른 바다와 하늘
차 돕다 내리다 이후 해산|드랍오프 및 해산
오후 6:00 아마|오후 6:00 예정
차 타다 운전 공항 곳 안전 도착|공항으로 안전하게 차량이동
쉬다 기분 좋다 2박 3일 여행|쉼과 낭만이 가득한 2박 3일
여수 순천 곳 보다 모두 아름답다|시선이 머무는 모든 곳이 아름다운 여수와 순천
2021년 국내 여행 다시 시작 때 가장 가고 싶다 여행 곳 1위,|2021 국내 여행 재개 시, 첫 국내 여행 희망 방문지 1위,
여수 곳 국내 최고 바다 구경 쉬다 가능 도시|국내 최고 해양 관광 휴양 도시 여수!
순천 생태 여행 곳 2019년 1년 여행 사람 수 1천만 명 이상|2019년 연간 관광객 1천만 명을 넘긴 생태 관광 거점 도시 순천!
여수 순천 여행 사람 사랑 좋아하다 곳|관광객들에게 꾸준히 사랑 받고 있는 여수와 순천입니다.
여수 곳 밤 바다 아름답다 여기 걷다 여행 편안 즐기다 무엇?|여수 밤바다의 아름다운 야경 속을 거닐며 편안한 여행을 즐겨보는 건 어떨까요?
눈 보다 모두 아름답다 여행 곳 가족 함께 추억 해보다|눈에 담는 모든 것이 아름다운 여행지에서 가족과 따뜻한 추억을 만들어봐요.
구경 여행 유명하다 곳 가장 아름답다 모습 보다|관광 명소의 가장 아름다운 모습 포착!
손님 맞추다 구경 유명하다 곳 시간 때 따르다 아름답다 모습 보다 가능|시간에 따라 달라지는 명소의 모습을 고려한 고객 맞춤 일정!
투어뮤즈 사진 예쁘다 찍다|투어뮤즈가 찍어주는 인생샷 GET!
투어뮤즈 아름답다 모습 배경 사진 찍다 주다|아름다운 풍경을 배경으로 투어뮤즈가 찍어주는 인생샷을 건져봐요!
집 앞 차 돕타 타다 출발 여수 도착|집 앞에서 여수까지 제공되는 차량!
거리 멀다 운전 피곤 없다 여행 100% 즐기다 가능|장거리 운전으로 인한 피로를 잊고 여행을 100% 즐길 수 있어요.
기본 선택|기본옵션
어린이 평일/주말 1인당 506,000원|어린이 평일/주말 1인당 506,000원
어른 평일/주말 1인당 523,000원|어른 평일/주말 1인당 523,000원
기록 요금 보통 때 , 주말 또 공식 쉬다 날 가격 오르다 아마|상기 요금은 평일 기준이며, 주말/공휴일 등에는 가격이 올라갈 수 있습니다.
고소동 벽화 골목 1시간 30분 아마|고소동 벽화골목 1시간 30분 소요 예정
모습 예쁘다 귀엽다 골목길 구경|아기자기한 골목길을 구경해요.
진남관 부터 여수 해양 공원 도착 길이 1,004m 때문이다|진남관부터 여수해양공원까지의 길이가 1,004m이기에
고소동 벽화 골목 별명 천사 벽화 골목 부르다 언덕 곳 있다 바다 또 돌산 다리 보다 가능|‘천사벽화골목’으로도 불리고 있는 고소동 벽화골목은 언덕에 위치해 있어 바다와 돌산대교를 한 눈에 볼 수 있어요.
벽화 색 다양 있다 사진 예쁘다 찍다 가능 또 구경 예쁘다 카페 곳 쉬다 가능|여러 색감의 벽화들로 가득한 다양한 포토존에서 예쁜 사진을 남기고 뷰가 좋은 카페거리에서 잠시 쉬어갈 수도 있답니다!
하멜 등대 15분 아마|하멜등대 15분 소요 예정
여수 대표 유명하다 곳|여수의 랜드마크
하멜 등대 여수 방문 꼭 가다 필요 곳|여수를 오면 꼭 봐야 하는 하멜등대는
등대 만들다 왜? 17세기 때 사람 이름 하멜 배 부시다 때문이다 여수 있다 이후 집 다시 돌아가다 기념 목적|17세기 배 난파로 여수에 억류되어 있다가 고향으로 돌아간 하멜을 기념하기 위해 세워진 등대입니다.
등대 아름답다 여수 앞바다 보다 가능 사진 찍다|아름다운 여수 앞바다가 보이는 등대 앞에서 기념 사진 한 장 남겨봐요.
해상 케이블카&돌산공원 1시간 30분 아마|해상 케이블카&돌산공원 1시간 30분 소요예정
바다 위 재미있다|바다를 건너가는 짜릿함
바다 위 타다 케이블카 아시아 가운데 홍콩, 싱가포르, 베트남 다음 네번째 여수 곳바다 위 타다 케이블카 재미있다 또 바다 아름답다 구경 좋다|바다 위를 통과하는 해당 케이블카는 아시아에서는 홍콩, 싱가포르, 베트남에 이어 네번째가 여수의 해상 케이블카인데요. 해상 케이블카를 타고 짜릿한 스릴감과 아름다운 바다를 느껴보세요.
돌산 공원 곳 여수 모습 구경 보다 또 돌산 대교 불 켜지다 켜지다 보다 가능|돌산공원에서 여수의 파노라마 뷰와 서서히 켜지는 돌산대교의 야경도 볼 수 있어요.
둘째 날 눈 보다 즐기다 마음 여유|눈으로 즐기고 마음은 여유롭게! 2일차 일정
트릭 아트 체험 2시간 아마|트릭아트체험 2시간 소요 예정
여수 예술 랜드 AR 어플 다운 돕다 받다 300% 더 즐기다|AR 어플과 함께 여수 예술랜드 300% 즐기기
여수 예술 랜드 테마 박물관 국내 가장 크다 곳 트릭 아트 체험 가능|국내 최대 테마형 뮤지엄인 여수 예술랜드에서 다양한 트릭아트 체험을 해봐요.
트릭 아트 AR 카메라 보다 재미있다 또 사진 영상 여러가지 찍다 가능|AR 카메라로 보는 트릭아트는 재미는 물론, 다양한 연출을 통해 재미있는 사진과 영상을 남길 수 있어요.
미디어 아트&조각 공원|미디어아트&조각공원
여수 예술 랜드 마음 여유롭다 구경|여유롭게 둘러보는 여수 예술랜드
여수 예술 랜드 거리 50m 미디어 터널 또 인공 암반 동굴 걷다 도착 아름답다 조각 공원 보다|여수 예술랜드의 50m 미디어 터널과 인공암반동굴을 지나 아름다운 조각공원을 둘러봐요.
전망대 마이다스 손 모양 또 조각 작품 보다 시간 빠르다 즐기다|전망대 마이다스의 손과 조각작품들로 시간 가는 줄 모르고 즐기게 됩니다.
넓다 크다 풍경 보다 시간 여유롭다 해보다|탁 트인 풍경을 바라보며 여유로운 시간을 보내세요.
항일암 1시간 30분 가능|향일암 1시간 30분 소요 예정
남해 보다 가능 곳|남해를 담은 곳
여수 10경 항일함 넓다 크다 남해 보다 가능 곳|탁 트인 파노라마 뷰의 남해를 볼 수 있는 여수 10경 향일함입니다.
동자승 몸 모습 다양 똑같다 따르다 또 예쁘다 절 구경 가능|다양한 포즈의 동자승 동상들을 따라해 보고 예쁜 절을 둘러봐요.
겨울부터 봄 때 동백꽃 피다 보다 가능|겨울부터 봄 사이엔 만개한 동백꽃도 보실 수 있어요.
와온 해변 30분 아마|와온해변 30분 소요 예정
일몰 보다 아름답다 바다 곳|일몰이 아름다운 해변
썰물 원인 개펄 갈대밭 물길 S자 모양 되다 바다 보다 아름답다 유명하다 곳|썰물로 만들어지는 S자 라인의 물길, 개펄과 갈대밭 위에 그려지는 아름다운 일몰이 유명한 해변입니다.
겨울 때 철새 날다 오다 구경 멋있다|겨울엔 철새들이 날아와 장관을 이루기도 해요.
순천 산 바다 동물 식물 아름답다 곳|순천이 보여주는 자연의 아름다움
3일차 하루 계획|3일차 일정
여행 마지막 날|여행의 마지막날
순천만 습지 2시간 아마|순천만 습지 2시간 소요 예정
세계 5대 연안습지|세계 5대 연안습지
순천만 습지 사람 산 바다 동물 식물 함께 살다 또 하늘 은혜 환경 멋있다 구경 보다 여유 느끼다|인간과 자연이 공존하고 천혜의 자연환경을 갖춘 순천만 습지를 돌아보며 여유를 느껴봐요.
용산 전망대 곳 산 바다 또 습지 모습 어울리다 아름답다 보다 가능|용산 전망대에서 산과 바다 그리고 습지가 이루는 아름다운 조화도 볼 수 있어요.
순천 드라마 촬영장 1시간 30분 아마|순천 드라마 촬영장 1시간 30분 소요예정
드라마 한 모습|드라마의 한 장면 속으로
1960~1980년 대 서울 관악구 달동네 모습 있다 넓다 얼마? 12,000평 매우 크다 곳|1960~1980 년대 당시 서울 관악구 달동네의 모습을 생생하게 간직하고 있는 12,000평의 국내 최대 규모 촬영장입니다.
매우 많다 유명하다 인기 있다 드라마 주인공 똑같이 다니다 무엇?|수많은 히트작이 탄생한 이곳에서 드라마 속 주인공이 되어 다녀보는 건 어떨까요?
순천만 국가 정원 2시간 아마|순천만 국가 정원 2시간 소요 예정
순천 대표 유명하다 곳|순천의 대표 명소
한국 제 1호 국가 정원 순천만 국가 정원 곳 여행 사람 꼭 가다 곳|대한민국 제1호 국가 정원 순천만 국가 정원은 관광객들이 빼놓지 않고 가는 순천의 MUST 스팟입니다.
깨끗 공기 또 예쁘다 정원 구경 보다 눈 편안하다 걷다 마음 여유 가능|맑은 공기와 아름답게 가꿔진 정원을 둘러보며 눈을 쉬게 해주고 산책을 하며 여유를 가져봐요.
만나다 차 타다 출발|픽업 및 이동
곳 따르다 다르다|위치에 따라 상이
결정 곳 만나다 차 타다 이후 여수 곳 이동|지정된 장소에서 픽업 후 여수로 이동
고소동 벽화골목|고소동 벽화골목
1시간 30분 아마|1시간 30분 소요 예정
벽화 마을 구경 보다|벽화마을 둘러보기
하멜 등대|하멜등대
15분 아마|15분 소요 예정
등대 곳 기념 촬영, 여수 앞바다 구경 여행|등대에서 기념촬영, 여수 앞바다 관광
해상 케이블카 & 돌산공원|해상 케이블카 & 돌산공원
1시간 30분 아마|1시간 30분 소요 예정
케이블카 탑승 이후 돌산 공원 곳 여수 구경 관람|케이블카 탑승 후 돌산공원에서 여수 전경 관람
저녁 식사|저녁식사
1시간 아마|1시간 소요 예정
여행 지역 곳 방식 식사|현지식 식사
숙소 곳 가다|숙소로 이동
방 승인 확인 이후 쉬다|체크인 후 휴식
2일차|2일차
아침 식사|아침식사
오전 8시 30분 아마|오전 8시 30분 예정
여수 예술랜드|여수 예술랜드
2시간 아마|2시간 소요
국내 가장 크다 테마형 뮤지엄 여수 예술랜드 곳 트릭아트 다양 체험|국내 최대 테마형 뮤지엄인 여수 예술랜드에서 다양한 트릭아트 체험
점심식사|점심식사
1시간 아마|1시간 소요 예정
여행 지역 곳 방식 식사|현지식 식사
향일암|향일암
1시간 30분 아마|1시간 30분 소요 에정
넓다 크다 남해 구경 가능 여수 10경 향일암 구경 여행|탁 트인 파노라마 뷰의 남해를 볼 수 있는 여수10경 향일암 관광
모이핀|모이핀
1시간 아마|1시간 소요 예정
여수 곳 유명하다 카페 휴식|여수의 유명한 카페에서 휴식
와온해변|와온해변
30분 아마|30분 소요 예정
해변 곳 일몰 구경|해변에서 일몰 감상
저녁 식사|저녁식사
1시간 아마|1시간 소요 예정
여행 지역 곳 방식 식사|현지식 식사
숙소 곳 가다|숙소로 이동
방 승인 확인 이후 휴식|체크인 후 휴식
3일차|3일차
아침 식사|아침식사
오전 8시 아마|오전 8시 예정
호텔 조식 식사|호텔조식 식사
순천만 습지|순천만습지
2시간 아마|2시간 소요 예정
세계 5대 연안 습지 순천만 구경 보다|세계 5대 연안습지인 순천만 돌아보기
점심 식사|점심식사
1시간 아마|1시간 소요 예정
여행 지역 곳 방식 식사|현지식 식사
순천 드라마 촬영장|순천 드라마 촬영장
1시간 30분 아마|1시간 30분 소요 예정
국내 가장 크다 촬영장 구경 보다|국내 최대 규모의 촬영장 관람하기
차 내리다  해산|드랍오프 및 해산
곳 따르다 다르다|위치에 따라 상이
차 운전 안전 집 도착|집으로 안전하게 차량이동
아이 보호 여행 강릉 여유 구경 여행|찬찬히 둘러보는 강릉 아이 돌봄 여행
기분 충분|감성 충만
강릉 1박 2일|강릉 1박 2일
바다 깊다 물고기 보다 또 직접 만들다 맥주 마시다 여행 즐기다|바닷속 친구와 만나고 수제 맥주도 즐기는 여행
분리 또 함께, 강릉 여유 보다|따로 또 같이, 찬찬히 둘러보는 강릉의 감성
강릉 곳 직접 만들다 맥주 유명 알다 있다?|강릉에 수제 맥주가 유명하다는 사실 알고 계셨나요?
강릉 곳 바다 보다 또 직접 만들다 맥주 마시다 기분 만족|감성을 촉촉하게 채워 줄 강릉의 바다와 수제 맥주의 조합!
가족 함께 주문진항 곳 전통 시장, 오죽헌, 강릉 곳 파랗다 바다 보다 즐기다|가족이 함께 주문진항, 전통 시장, 오죽헌, 강릉의 푸른 바다에 빠져 보고
분리 또 함께 어른 브루어리 곳 놀다 아이 아쿠아리움 경험 다양 하다|따로 또 같이 어른은 브루어리에서 아이는 아쿠아리움에서 이색적인 체험을 하며,
모두 만족 즐기다 좋다 가능|모두가 만족할 수 있는 일정을 즐겨 보세요.
강릉 시원하다 맥주 공장 체험|시원한 강릉의 맥주 브루어리 체험
맥주 공장 체험 아이 함께 가다 어렵다|아이와 함께 가기 어려웠던 브루어리 체험
한국 처음 맥주 전통 술 양조장 같이 보다 가능|전국 최초로 맥주와 전통주 양조장이 함께
경포 아쿠아리움 아이 가장 좋다 곳|아이들의 최애 핫스팟 경포 아쿠아리움
크다 물고기, 다양 물고기 또 수달 보다 시간 즐기다 좋다|대형 어류, 다양한 어종 뿐 아니라 수달도 만날 수 있는 즐겁고 신나는 시간
강릉 대표 구경 여행 곳 아이 함께 방문|강릉 대표 관광지는 아이와 함께 방문
우리 가족 소중하다 여행 대표 구경 여행 곳 투어뮤즈 가족 사진 찍다 있다|우리 가족의 소중한 여행, 대표 관광지에서 찍는 가족사진은 투어뮤즈에서 챙겨드려요.
기본 옵션|기본옵션
어린이 평일/주말 1인 당 321,000원|어린이 평일/주말 1인당 321,000원
어른 평일/주말 1인 당 361,000원|어른 평일/주말 1인당 361,000원
기록 요금 보통 때 , 주말 또 공식 쉬다 날 가격 오르다 아마|상기 요금은 평일 기준이며, 주말/공휴일 등에는 가격이 올라갈 수 있습니다.
불포함 사항|불포함 사항
기타 개인 경비|기타 개인 경비
포함 사항|포함 사항
아이 보호 서비스|아이 돌봄 서비스
수도권 제외 추가 비용 발생|수도권 제외 추가 비용 발생
강릉 맥주 공장 곳 구경 쉽다 아니다|쉽게 만나보지 못했던 강릉의 브루어리
주문진항|주문진항
수산 시장 역사 있다|역사를 가진 수산시장
주문진 수산 시장 주문진항 가깝다 곳 있다 1936년 부터 지금 까지 역사 계속 구경 느끼다 가능|주문진항 인근에 자리한 주문진 수산시장에는 1936년부터 지금까지 이어져 온 역사를 지닌 어촌의 정취를 듬뿍 느낄 수 있어요.
새롭다 깨끗하다 물고기 회 또 바다 바람 불다 만들다 건어물 있다 또 구경 보다 멋있다|싱싱한 횟감부터 해풍에 잘 말린 건어물까지 입맛을 돋우는 풍경이 멋지답니다.
주문진 방사제 곳 촬영 유명하다 곳|주문진 방사제는 유명한 촬영 관광지로도 알려져 있습니다.
향호해변&주문진해변|향호해변&주문진해변
포토존 강릉 꼭 방문 필요 곳|강릉 필수 방문 포토존
2016  한국 깨끗 바다 20 곳 중 주문진 바다 선택 바다 깊다 없다 또 사람 많다 없다 가족 함께 여행 좋다|2016 전국 청정 해수욕장 20선 중 하나로 선정된 주문진 해변은 수심이 낮고 사람들이 붐비지 않아 가족 여행에 적합한 곳입니다.
춤추다 노래 부르다 무리 BTS 이 곳 버스 타다 곳 노래 동영상 찍다 목적 임시 만들다|특히 BTS가 뮤비를 촬영해 유명해진 버스 정류장은 뮤비 촬영을 위해 임시로 만들어진 장소였는데요,
하지만 이 곳 사람 많다 가다 구경 때문 사진 찍다 곳 되다|관광지를 찾는 많은 관광객들의 성원 덕에 포토스팟으로 재탄생 했다고 해요.
경포 아쿠아리움|경포 아쿠아리움
바다 물고기 보다 시간|바닷속 친구들을 만나보는 시간
경포 아쿠아리움 곳 동해안 석호 경포호 바다 호수 모이다 곳 또 생태 구경 여행 유명하다|바다와 호수가 만나는 동해안 대표 석호 경포호와 생태 관광의 명소 경포 가시연 습지를 끼고 있는
경포 가시연 습지 곳 같다 있다 독특 환경 보다 가능 곳|경포 아쿠아리움은 경포호의 특수한 생태 환경을 보여주는 매력적인 곳이에요.
크다 물고기 다양 물고기|대형어류, 다양한 어종 뿐 아니라 경포 아쿠아리움의 마스코트이자
또 경포 아쿠아리움 곳 대표 수달 있다 아이 수달 좋다 인기 많다|어린이들에게 최고의 인기를 자랑하는 수달도 함께 살고 있다고 합니다.
강릉 맥주 공장 곳|강릉 브루어리
강릉 대표 독특 체험|강릉 대표 이색 체험
한국 처음 직접 만들다 맥주 만들다 곳 또 전통 술 만들다 곳 같이 가지다 사장님 있다|전국 최초 수제 맥주 양조장과 전통주 양조장을 동시에 보유하고 계신 사장님으로부터
곳 가다 직접 맥주 만들다 방법 또 기계 보다 가능|직접 맥주가 만들어지는 원리와 브루잉 기계가 어떻게 동작 하는지를 들을 수 있어요.
바로 만들다 맥주 마시다 가능 좋다|바로 만든 생맥주 시음이 체험의 키 포인트!
전통 술 만들다 체험 때 직접 만들다 전통 술 집 가져가다 가능|전통주 만들기 체험에서는 직접 만든 전통주를 집으로 가져가실 수 있습니다.
월화거리|월화거리
식사 포함 2시간 30분 아마|식사 포함 2시간 30분 소요 예정
강릉 세월 보다 가능 거리|강릉의 세월을 담고 있는 거리
월화거리 강릉역 부터 폐철도 걷다 길 길이 약 2.6km|강릉역에서 시작해 가로지르는 폐철도를 따라 조성된 약 2.6km의 산책로인 월화거리!
거리 곳곳 예쁘다 만들다 꾸미다 물건 있다 또 골목 모습 세월 보다 가능 합 분위기 독특|거리 곳곳에는 예쁜 조형물과 세월의 흔적을 고스란히 지닌 골목 풍경이 어우러져 독특한 분위기를 자아내고 있습니다.
가족 함께 전통 시장 곳 간식 구경 가능|전통 시장에서 가족과 함께 간식거리를 구경해 보는 것도 여행에서 빼놓을 수 없는 코스겠죠?
강릉 늦다 걷다 구경 가능|찬찬히 걸어서 둘러볼 오늘의 강릉
오죽현|오죽현
역사 또 추억 있다 곳|역사와 추억이 묻어 있는 곳
강릉 대표 사람 생각나다 누구? 신사임당 이율곡 맞다?|강릉을 대표하는 인물하면 역시 신사임당과 이율곡이 떠오르지 않으세요?
오죽헌 곳 신사임당 이율곡 태어나다 자라다 곳 강릉 역사 또 문화 보다 가능|오숙헌은 신사임당과 이율곡이 나고 자란 곳으로 강릉의 역사와 문화를 보여주는 명소입니다.
오죽헌 이름 의미 무엇? 집 주변 검다 대나무 숲 넓다|집 주위에 검은 대나무 숲이 울창하다는 뜻에서 유래한 이름 오죽헌!
역사 추억 보다 가능 곳 투어 뮤즈 가족 사진 찍다 있다|역사와 추억이 생생한 장소에서 투어뮤즈가 가족사진을 남겨드려요.
에디슨 과학 박물관|에디슨 과학 박물관
축음기 또 발명 물건 매우 많다 아이 과학 놀다 곳|축음기와 발명품이 잔뜩! 우리 아이들의 과학놀이터
에디슨 발명 물건 또 전세계 다양 축음기 모이다 구경 보다 곳 있다|에디슨의 발명품들 그리고 전세계의 다양한 축음기를 한 곳에 모아놓은 전시관이 있습니다.
아이 음향 기계 비유 오르골, 축음기, 라디오 역사 보다 가능|우리 아이들은 오르골, 축음기, 라디오 등 음향기기의 역사를 살펴 볼 수 있고,
또 에디슨 직접 만들다 발명 물건 보다 가능|에디슨의 손에서 탄생한 발명품들도 같이 만나볼 수 있어요.
허균 허날설헌 기념관|허균 허날설헌 기념관
문향 도시 강릉|문향의 도시 강릉
강릉 곳 문향 도시 부르다 이유 무엇? 태어나다 부터 재능 뛰어나다 허난설헌 또 허균 태어나다 자라다 곳|강릉을 문향의 도시라고 부르는 이유는 비범한 재능을 타고난 문장가 허난설헌과 허균이 태어난 곳이기 때문입니다.
허난설헌 태어나다 집 곳 기본 집 또 문 옆 집 있다 이 곳 예전 사대부 한옥 집 모습 보다 가능|본채와 행랑채로 이루어진 허난설헌 생가터는 전형적인 사대부가의 한옥 양식을 보여주고 있어요.
전통차 체험 곳 공원 안 있다 차 마시다 여유 즐기다 가능|공원 내에 있는 전통차 체험관에서는 향긋한 차 한잔의 여유까지 즐겨보실 수 있습니다.
경포호수공원|경포호수공원
산책길 나만 알다 원하다|나만 알고 싶은 산책길
경포 호수 공원 산책길 가깝다 허난설헌 허균 기념 곳 강문 바다 있다 구경 걷다 가능|경포 호수 공원 산책길, 허난설헌 허균 기념관, 강문해변 등 주변 관광지를 자유롭게 거닐어 보실 수 있어요.
경포호 산책길 약 4km 길이 자연 모습 또 테마 꾸미다 예쁘다 있다 걷다|약 4km에 이르는 경포호 산책로, 걷는 동안 심심할 틈이 없게 하는 자연의 모습과 테마에 맞게 잘 꾸며져 있는 조형물까지,
심심 없다 또 마음 여유 좋다 곳|여유로운 산책 시간을 갖기에 좋은 관광지입니다.
대관령 양떼목장|대관령 양떼목장
바람 흔들리다 푸르다 산 비탈 곳|바람에 흔들거리는 푸른 초지
대관령 양떼목장 동물 풀 뜯다 먹다 풀 넓다 곳|드넓은 목초지의 여유, 대자연을 느낄 수 있는 대관령 양떼목장.
동양 지역 가장 크다 넓다 약 600만 평 이 곳 산 비탈 또 동물 보다 가능|동양 최대 600만 평의 규모를 자랑하며 드넓은 초지와 동물, 살아있는 자연을 느낄 수 있어요.
목책로 구간 수 다섯 개 있다 가운데 곳 하나 걷다 구경 추천|총 다섯 개의 구간으로 나누어져 있는 목책로 구간 중, 한 구간이라도 꼭 걸어서 이동해 보시는 것을 추천합니다.
차 돕다 타다 출발|픽업 및 이동
곳 따르다 다르다|위치에 따라 상이
결정 곳 차 돕다 타다 이후 강릉 곳 출발|지정된 장소에서 픽업 후 강릉으로 이동
점심 식사|점심식사
1시간 30분 아마|1시간 30분 소요 예정
여행 지역 곳 방식 식사|현지식 식사
향호 해변|향호해변
1시간 아마|1시간 소요 예정
향호 바다 곳 기념 사진 찍다, 해변 구경 여행|향호해변에서 기념촬영, 해변 관광
경포 아쿠아리움|경포 아쿠아리움
2시간 아마|2시간 소요 예정
경포호 곳 독특 생태 환경 체험|경포호의 특수한 생태 환경 체험
강릉 월화거리|강릉월화거리
1시간 아마|1시간 소요 예정
강릉역 부터 폐철도 걷다 구경|강릉역에서부터 시내를 가로지르는 폐철도를 따라 조성된 산책로 걸어보기
저녁 식사|저녁식사
1시간 30분 아마|1시간 30분 소요 예정
여행 지역 곳 방식 식사|현지식 식사
숙소 곳 출발|숙소로 이동
방 승인 확인 이후 휴식|체크인 후 휴식
2일차|2일차
아침 식사|아침식사
오전 8:30분 아마|오전 8:30분 예정
호텔 조식 식사|호텔조식 식사
오죽헌|오죽헌
1시간 아마|1시간 소요 예정
강릉 역사 또 문화 구경 체험 유명하다 곳|강릉의 역사와 문화를 보여주는 명소 체험
에디슨 과학 박물관|에디슨 과학 박물관
2시간 아마|2시간 소요 예정
에디슨 만들다 물건 또 다양 축음기 합 보다 구경 가능 곳|에디슨의 발명품과 다양한 축음기를 한 곳에 모아 놓은 전시관
점심 식사|점심식사
1시간 아마|1시간 소요 예정
여행 지역 곳 방식 식사|현지식 식사
대관령 양떼목장|대관령 양떼목장
2시간 아마|2시간 소요 예정
대관령 양떼 목장 체험 자연 경험 가능|대자연을 느낄 수 있는 대관령 양떼목장 체험
차 돕다 내리다 이후 해산|드랍오프 및 해산
곳 따르다 다르다|위치에 따라 상이
차 운전 안전 집 도착|집으로 안전하게 차량 이동
아이 보호 여행 제주도 곳 놀다 또 쉬다|놀면서 쉬면서 만들어보는 나의 제주, 아이돌봄 여행
제주도 곳 아름답다 자연 또 다양 음식 구경 많다 여행 가장 원하다 곳 1위|아름다운 자연과 다양한 음식, 볼거리들로 변함없는 부동의 국내 희망 관광지 1위 제주.
섬 화산 폭포 해변 국립 공원 동굴 숲 구경 곳 많다 또 사람 수 보다 박물관 미술 구경 곳 수 많다|세계적 자연 경관의 모든 테마 (섬, 화산, 폭포, 해변, 국립 공원, 동굴, 숲)를 갖추고 있으면서도 인구 수 대비 미술관,
전국 박물관 미술 구경 곳 수보다 6배 더 많다|박물관 수가 국내 평균의 6배나 될 만큼 많은 “미술의 섬”이기도 합니다.
맛있다 음식 다양 많다 또 물 깨끗 공기 깨끗 제주도 곳 구경 부탁|산해진미가 가득한 물 좋고 공기 좋은 제주도에서 자연과 예술의 아름다움에 한껏 빠져들어 보아요.
함께 구경 즐기다 또 시간 자유 마음 여유 가능|함께하는 즐거움과 자유 시간의 여유를 둘 다 드려요.
가족 모두 함께 여행 구경 또 아이 어른 분리 여행 구경 가능|공통 코스에서는 가족 모두 함께하고 아이와 떨어져 어른 코스를 즐겨봐요.
2박 3일 동안 여행 무엇?|2박 3일간의 환상의 여정 조합
아름답다 산 바다 구경 박물관 미술 구경 곳 또 음식 맛있다 곳 여행 즐기다 크다|아름다운 자연, 뮤지엄, 맛집 등 최상의 일정 구성으로 여행의 즐거움 UP
제주 문화 생활 200% 즐기다|제주의 문화생활 200% 즐기기
어른 아이 취향 맞추다  또 테마 파트 구경|어른과 아이들의 취향에 맞는 각종 뮤지엄과 테마파크로 문화와 감성을 꽉 채워봐요.
기본 선택|기본옵션
어린이 평일/주말 1인 당 511,000원|어린이 평일/주말 1인당 511,000원
어른 평일/주말 1인 당 550,000원|어른 평일/주말 1인당 550,000원
불포함 사항|불포함사항
제주도 왕복 항공권|제주도 왕복 항공권
포함 사항|포함사항
차 돕다 타다 (제주 공항 기준)|픽업서비스 (제주공항 기준)
혼저옵서예,|혼저옵서예,
여기 곳 제주도 입니다|여기는 제주도입니다.
넥슨 컴퓨터 박물관|넥슨 컴퓨터 박물관
컴퓨터 또 게임 역사 있다 곳|컴퓨터와 게임의 역사를 담은
넥슨 컴퓨터 박물관 아시아 지역 가장 처음 곳 컴퓨터 또 게임 역사 보다 가능|아시아 최초의 컴퓨터 박물관으로 유명한 넥슨 컴퓨터 박물관은 컴퓨터와 게임의 역사를 잘 간직하고 있습니다.
VR 체험 가능 곳 있다 또 도서관 모습 비슷 오락실 전용 집 전용 게임 구경|VR체험시설은 물론 오락실용&가정용 게임이 도서관 컨셉으로 전시되어 있으며
또 직접 체험 가능 때문이다 여행 사람 방문 많다|직접 체험이 가능하여 많은 관광객들이 방문합니다.
2번째|그러므로 part.2
커피 마시다 여유 가능 곳|커피와 여유가 있는 곳
제주도 카페 곳 최근 가장 인기 많다 커피 마시다 여유|요즘 가장 핫한 제주 감성이 가득한 카페에서 커피 한 잔의 여유를 가져보세요.
카페 집 겉 모습 깨끗 미술 구경 곳 모습 비슷 이 곳 기념 사진 찍다|모던한 건축물 외관으로 미술관에 온 듯한 느낌을 주는 카페에서 기념사진도 촬영하고
또 밖 유채꽃 가득 눈 보다 즐기다 가능|유채꽃이 가득한 야외는 눈이 즐거워지는 여행으로 만들어줘요.
천지연 폭포|천지연 폭포
제주도 3대 폭포|제주도 3대 폭포
천지연 폭포 의미 무엇? 하늘 땅 만나다 연못 생기다 의미 있다|천지연폭포는 하늘과 땅이 만나서 이른 연못이라는 뜻을 가지고 있습니다.
폭포 곳 가다 길 또 폭포 물 흐르다 있다 숲 또 산 물 흐르다 소리 마음 여유 돕다 좋다|산책하기 좋은 폭포로 가는 길, 폭포수가 흐르는 아름다운 숲과 자연의 소리는 최고의 힐링 공간이 됩니다.
송악산|송악산
해안 절경 보다 가능 곳|해안절경을 볼 수 있는 곳
송악산 바다 옆 길 10 곳 산 오르다 눈 둘러보다 한라산 산방산|올레길 10코스이기도 한 송악산에 올라서 전망대에서 바라본 한라산과 산방산과
또 용머리 바다 보다 그림 같다 멋있다|용머리해안의 아름다운 조화로움이 한 폭의 그림을 보는 듯한 느낌을 가져다 줍니다.
바다 보다 마라도 가파도 섬 두 개 보다 가능|시야가 바다를 향하면 마라도 가파도 형제 섬들이 한눈에 들어오고,
10분 걷다 송악산 정상 분화구 보다 가능 꼭 구경 필요 곳|10분 정도 걸어가면 송악산 정상 분화구를 볼 수 있는데, 이곳 또한 놓치지 말아야 할 곳 중에 하나입니다.
이니스프리 제주 하우스|이니스프리 제주 하우스
오설록 이니스프리 제주 하우스 제주 어울리다 곳|제주스러움을 잘 담은 오설록의 이니스프리 제주 하우스
녹차 밭 넓다 크다 곳 가깝다 이니스프리 제주 하우스 있다|드넓은 녹차밭이 펼쳐진 곳에 이니스프리 제주 하우스가 있습니다.
집 건물 모습 예쁘다 매우 또 기념 사진 찍다 많다 때문이다 사계절 계속 여행 구경 사람 많다|자연 친화적인 건물 외관 자체도 너무 예쁘고 기념 사진도 촬영할 수 있어 사계절 내내 방문객이 많다고 해요.
이니스프리 제주 하우스  곳 비누 직접 만들다 가능|제주스러움이 물씬 느껴지는 이니스프리 제주 하우스에서 비누 만들기 체험으로 나만의 쳔연 비누를 만들어봐요.
오설록 차 박물관|오설록 티 뮤지엄
녹차 향 있다|녹차향이 솔솔
제주 오설록 차 박물관 곳|자연을 생각하는 제주 오설록 티 뮤지엄!
오설록 차 박물관 제주 서광 차 밭 가깝다 이 곳 차 또 한국 전통 차 문화 알려주다|제주 서광 차밭과 맞닿아 있는 오설록티 뮤지엄은 아모레퍼시픽이 차와 한국 전통차 문화를 소개하고
또 보내다 목적 2001년 9월 한국 처음 차 박물관 설치하다|보급하고자 2001년 9월에 개관한 국내 최초의 차 박물관입니다.
세계 유명하다 디자인 건축 전문 사이트 이름 붐 곳 세계 미술 구경 곳 10대 중 제주도 차 박물관 포함|세계적인 디자인 건축 전문 사이트인 디자인 붐이 선정한 세계 10대 미술관에 오를 만큼 안팎으로
곳 아름답다 매년 구경 여행 사람 수 150만 명 방문 정도 제주 가장 문화 유명하다 곳|아름다운 풍경을 뽐내는 티 뮤지엄은 연간 150만 명의 관람객이 방문하는 제주 최고 명소이자 문화 공간입니다.
현재해수욕장|협재해수욕장
제주 곳 가장 바다 색 아름답다 곳|제주도에서 바다색이 가장 아름다운 곳
협재 곳 바다 색 에메랄드 때문 제주도 곳 여행 구경 사람 꼭 방문 있다|에메랄드 색 바다를 품고 있는 협재 해수욕장은 많은 관광객들이 제주도를 방문하면 꼭 들르는 해수욕장입니다.
바다 너머 비양도 모습 제주 바다 아름답다 보다 멋있다|바다 너머로 보이는 비양도는 예쁜 제주 바다와 어우러져 아름다운 뷰를 선사합니다.
테디베어 사파리|테디베어 사파리
원래 사파리 다르다|기존의 사파리와는 다르다.
세계 처음 실제 동물 모습 완전 똑같다 인형 만들다|세계 최초로 실제 동물 크기로 제작된 인형 사파리입니다.
원래 테디베어 박물관 더하다 아프리카 나라 곳 뿐 보다 가능 동물|본래의 테마로 꾸며진 테디베어 박물관의 콘텐츠 뿐만 아니라 아프리카 오지에서만 볼 수 있는 동물들과
또 동물 모습 똑같다 만들다 동물 인형 외 다르다 구경 보다 많다|제 동물의 크기로 제작된 신기한 동물 인형을 비롯해 재미와 볼거리가 가득한 곳입니다.
아르떼 박물관|아르떼 뮤지엄
국내 가장 크다 박물관|국내 최대 규모의 박물관
세계 최고 디지털 디자인 회사 이름 d’strict 곳 만들다 한국 미디어 예술 전시 구경 곳|세계 수준의 디지털 디자인 컴퍼니 d’strict가 선보이는 국내 최대 몰입형 미디어 아트 전시관입니다.
원래 스피커 만들다 공장 하지만 매우 크다 넓다 곳 바꾸다 약 10m 정도|기존의 스피커 제조 공장으로 사용되던 공간을 최대 10m에 육박하는 웅장한 공간으로 탈바꿈 시켜
주제 자연 영원 빛 소리 이용 미디어 예술 구경 만들다|빛과 소리가 만든 영원한 자연을 주제로 한 다양한 미디어 아트 전시가 펼쳐집니다.
속앗수다예 마지막 제주 추억|속앗수다예, 마지막은 나만의 제주 남기기
동문 제리 시장 15분 아마|동문 재리 시장 15분 소요 예정
제주 자연 보다 가능 곳|라이브한 제주를 느낄 수 있는 장소
제주 곳 좋다 감귤 또 과일 제주만 있다 물건 화산 흙 곳 풀 자라다 또 깨끗 곳 물고기 고기|제주의 명품 감귤과 과일, 토산품, 화산토에서 자란 농산물, 청정한 자연환경 속에서 자란 수산물과 축산물,
오징어 문어 다양 있다|그리고 건어물이 준비되어 있는 곳입니다.
한국 우수 시장 원래 만들다 생기다 기록 있다 사다 물건 택배 보내다 가능|원산지 표시 우수 시장으로 구매한 상품을 바로 택배송 할 수 있는 시스템이 갖춰져 있는 전국에서 손꼽히는 우수 시장이며,
또 시장 안 곳곳 오메기떠 빙떡이떡 팔다 곳 집 분식 거리 또 전통 음식 먹다 시장 있다 먹다 가능|시장 내 곳곳에 오메기떡 빙떡이떡 집과 분식 거리, 그리고 전통 먹거리 시장이 있어 출출함도 달랠 수 있어요.
도두동 무지개 해안 도로|도두동 무지개 해안도로
색 다양 무지개 빛|알록달록 무지개 빛
해안 도로 파랗다 제주 바다 곳 색 다양 무지개 있다 느끼다|파란 제주 바다에 알록달록 무재개를 넣은 듯한 느낌을 주는 해안 도로입니다.
많다 여행 구경 사람 사진 찍다 유명하다 곳 추억 가능|많은 관광객들이 사진 명소로 부르고 있는 장소에서 예쁜 추억을 남겨봐요!
이호테우 해변 30분 소요 예정|이호테우 해변 30분 소요 예정
제주 최고 등대 있다 바다|제주 최고의 등대를 가진 해변
이호테우 곳 이름 의미 무엇? 이호동 마을 또 통나무 테우 배 합 만들다|이호테우는 이호동 마을과 테우라는 통나무 배를 합쳐서 붙여진 이름입니다.
이호테우 바다 공항 가장 가깝다 낮 밤 모두 아름답다 바다|이호테우 해변은 공항과 가장 가까운, 낮과 밤이 모두 아름다운 해변입니다.
제주도 여행 구경 사람들 흰색 빨간색 목마 등대 보다 위하다 방문|흰색과 빨간색의 목마 등대를 보기 위해 제주도에 오는 많은 관광객들이 이호테우 해변을 방문합니다.
아침미소 목장|아침미소목장
동물 친하다 주다 받다 가능 곳|동물과 교감할 수 있는 목장
젖소 송아지 먹다 주다 또 아이스크림 치즈 직접 만들다 체험 가능 곳|젖소와 송아지에게 먹이도 주고, 아이스크림과 치즈를 직접 만들어 볼 수 있는 체험 가득한 목장입니다.
도시 곳 체험 못하다 목장 곳 체험 배우다 생명 소중하다 깨닫다 또 동물 직접 만지다 즐기다|초록이 가득한 목장에서 도시에서 느껴볼 수 없었던 체험을 통해 생명의 소중함을 배우고 동물들의 체온을 직접 느껴봐요.
차 돕다 타다 가다|픽업 및 이동
제주 국제 공항 곳 차 돕다 타다|제주 국제 공항에서 픽업
점심 식사|점심식사
1시간 아마|1시간 소요 예정
여행 지역 곳 방식 식사|현지식 식사
넥슨 컴퓨터 박물관|넥슨 컴퓨터 박물관
1시간 30분|1시간 30분 소요 예정
박물관 컴퓨터 게임 역사 같다 다양 체험 구경 가능|컴퓨터와 게임의 역사를 함께 다양한 체험을 할 수 있는 박물관 관람
신기하다 도로|신비의 도로
15분 아마|15분 소요 예정
신기하다 도로 체험|신비의 도로 체험해보기
천지연 폭포|천지연 폭포
50분 아마|50분 소요 예정
천지연 폭포 제주도 3대 유명 폭포 구경|제주도 3대 폭포 중 하나인 천지연 폭포 관람
저녁 식사|저녁 식사
1시간 아마|1시간 소요 예정
여행 지역 곳 방식 식사|현지식 식사
숙소 곳 출발|숙소로 이동
방 승인 확인 이후 휴식|체크인 후 휴식
2일차|2일차
아침 식사|아침 식사
오전 8:15분 아마|오전 8:15분 예정
호텔 조식 식사|호텔 조식 식사
송악산 둘레길|송악산 둘레길
1시간 아마|1시간 소요 예정
구경 바다 멋있다 송악산 바다 옆 길 10 곳 걷다|올레길 10코스인 해안절경이 아름다운 송악산 산책
오설록 이니스프리 비누 만들다 체험|오설록 이니스프리 비누 만들기 체험
1시간 30분 아마|1시간 30분 소요 예정
나 마음 들다 그대로 직접 만들다 비누|천연 비누를 나만의 스타일로 만들어보기
점심 식사|점심 식사
1시간 아마|1시간 소요 예정
여행 지역 곳 방식 식사|현지식 식사
협재 해수욕장|협재 해수욕장
1시간 아마|1시간 소요 예정
협재 곳 에메랄드 바다 즐기다|협재 해수욕장에서 에메랄드 빛 바다 즐기기
테디 베어 사파리|테디 베어 사파리
1시간 30분 아마|1시간 30분 소요 예정
세계 처음 실제 동물 모습 완전 똑같다 인형 만들다 구경|세계 최초로 실제 동물 크기로 제작된 인형 사파리 관람
저녁 식사|저녁 식사
1시간 아마|1시간 소요 예정
여행 지역 곳 방식 식사|현지식 식사
숙소 곳 출발|숙소로 이동
방 승인 확인 이후 휴식|체크인 후 휴식
3일차|3일차
아침 식사|아침 식사
오전 8:30분 아마|오전 8:30분 예정
호텔 조식 식사|호텔 조식 식사
동문 재래 시장|동문 재래 시장
1시간 아마|1시간 소요 예정
동문 재래 시장 전통 음식 먹다 많다 또 구경|전통 먹거리 식당와 볼거리가 가득한 동문 재래 시장 돌아보기
도두동무지개 해안도로|도두동무지개 해안도로
15분 아마|15분 소요 예정
색 다양 무지개 해안 도로 곳 기념 사진 찍다|알록달록한 무지개색 해안 도로에서 기념 사진 촬영
이호테우 해변|이호테우 해변
30분 아마|30분 소요 예정
흰색 빨간색 목마 등대 또 제주 바다 보기|흰색과 빨간색의 목마 등대와 제주 바다 보기
점심 식사|점심 식사
1시간 아마|1시간 소요 예정
여행 지역 곳 방식 식사|현지식 식사
아침 미소 목장|아침 미소 목장
1시간 아마|1시간 소요 예정
제주 아름답다 풍경 보다 다양 체험|제주의 아름다운 풍경을 배경으로 여러 다양한 체험하기
차 돕다 내리다  해산|드랍오프 및 해산
차 운전 안전 공항 곳 도착|공항으로 안전하게 차량 이동
안동 구경 슬기 즐기다|슬기로운 안동 나들이
한국관광공사 또 관광거점도시 중 하나 안동 지역 알다 있다?|안동이 한국관광공사가 선정한 관광거점도시 중 하나라는 사실, 알고 계셨나요?
안동 여행 우리 가족 생활 피곤 휴식 가능|우리 가족의 지친 일상에 휴식을 가져다 줄 안동여행!
하회 마을 예전 선비 모습 보다 가족 모두 여유 즐기다|옛 선비의 흔적이 고스란히 남아있는 하회마을에서 온 가족이 함께 여유를 즐겨봐요.
이름 예끼 마을 곳 전통 예술 있다 아름답다 음악 또 그림 문학 포함 보다 가능|전통&예술의 공간, ‘예끼마을’에서는 아름다운 음악과 그림, 문학이 공존하는 다채로운 이야기를 들어볼 수 있어요.
안동 문화 도시 역사 미래 포함 있다 경험 아직 지금 기회 안동 출발 부탁|역사와 미래가 공존하는 문화도시 안동의 모습. 경험해보지 못하셨다면 이번 기회에 안동으로 떠나보세요.
차 마시다 하회 마을 보다|하회마을을 내려다보며 차 한잔
차 마시다 아이 함께 어렵다 하지만 부용대 차 마시다 여유|아이와 함께하기 어려웠던 티타임, 부용대 정상에서 여류로운 차 한잔
안동 파파야 농장 구경|안동에서 만나보는 파파야 농장
보통 때 열대 과일 보다 어렵다 아이 농장 직접 체험 가능|평소에 접해보기 어려웠던 열대과일, 우리 아이들에게 생생한 농장 체험을
아이 함께 대표 구경 여행 곳 방문|대표 관광지는 아이와 함꼐 방문
아이 우리 전통 선비 문화 가르치다 또 가족 사진 찍다 가능|우리 전통 고유의 선비문화를 아이들에게 알려주고 뜻깊은 가족 사진을 남기세요.
안동 선비 모습 똑같다 걷다|선비처럼 거닐어보는 안동
안동 하회 마을|안동 하회마을
한국 어울리다 곳|가장 한국적인 곳
하회 마을 한국 아름답다 또 전통 있다 이 곳 이름 풍산 류씨 600년 동안 계속 살다 마을 곳|한국의 미와 전통이 살아 숨쉬는 하회마을은 풍산 류씨가 600여 년간 대대로 살아온 한국의 대표적인 동성 마을이며,
기와 또 지푸라기 집 역사 오래되다 보존 잘하다 곳|와가와 초가가 오랜 역사 속에서도 잘 보존된 곳이예요.
마을 이름 하회 이유 무엇? 낙동강 모습 S자 같다 마을 감싸다 모습 유래|마을 이름을 하회라고 한 것은 낙동강이 ‘S’자 모양으로 마을을 감싸 안고 흐르는 데서 유래되었다고 합니다.
땅 사람 영향 좋다 곳 때문 안동 하회 마을 조선 시대 때 부터 사람 살다 가장 좋다 곳 유명|풍수지리적으로 좋은 위치에 자리하고 있어 조선시대에서부터 사람이 살기에 가장 좋은 곳으로 유명했던
방문 좋다 힘 받아 부탁|안동의 하회마을에서 좋은 기운을 받아 가세요.
하회 세계탈 박물관|하회 세계탈 박물관
나 직접 만들다 탈|내 손으로 직접 만들어보는 나만의 탈
하회 세계 탈 박물관 곳|탈 만들기 체험을 통해 아이들 창의력도 키우고, 우리 문화와 역사에 한 발짝 더 가까워질 수 있는 일석이조 체험,
아이 직접 탈 만들다 체험 창의력 발전 또 우리 문화 역사 친밀 배우다 체험 가능|하회세계탈박물관에서 함께해요.
부용대|부용대
하회 마을 눈 보다|하회 마을을 한 눈에 담아봐요.
부용대 곳 안동 하회 마을 곳 강 건너 소나무 숲 옆 절벽 있다|안동 하회 마을에서 강을 건너 소나무 숲 옆에서 자리하고 있는 절벽, 부용대.
낙동강 흐르다 곳 옥연정사 또 겸암정사 화천서원 있다|아래로 낙동강이 굽이 쳐 흐르는 곳에 옥연정사와 겸암정사, 화천서원이 자리하고 있습니다.
정상 곳 하회 마을 전체 보다 가능 이 곳 차 마시다 여유|정상에서 하회 마을 전체를 조망할 수 있는 시원한 풍경에서 여유로운 차 한잔 즐겨보세요.
월영교 밤|월영교의 밤
안동 아름답다 곳|안동의 감성을 담은 곳
안동 밤 모습 아름답다 보다 위하다 월영교 방문|안동에서 아름다운 야경을 즐기기 위해서는 월영교를 방문해 주세요.
월영교 아름답다 모습 색 다양 음악 분수 있다|색색의 음악 분수 아름다운 모습을 자랑하는 월영교,
무엇 부부 하나 아름답다 거룩하다 사랑 기념 목적 짓다 매우 멋있다|한 부부의 아름답고 숭고한 사랑을 기념하고자 지어졌다고 하니 더욱 감성적인 모습이네요.
안동 문화 도시 모습|문화 도시 안동의 모습
월영교|월영교
안동 영향 받다 따뜻하다|안동이 가진 따뜻함
월영교 아침 방문 영향 받다 따뜻하다 느끼다 가능|월영교가 가지고 있는 따뜻한 온기는 아침에만 느낄 수 있습니다.
어제 하루 마지막 때 보다 느끼다 다르다|어제 일정을 마무리하며 바라 본 월영교와는 사뭇 다른 느낌의 월영교.
다리 가운데 정자 곳 안동댐 모습 구경 보다|다리 가운데 앉아있는 정자에서 안동댐의 경치를 한눈에 담아보세요.
파파야 농장|파파야 농장
안동 대표 다양 체험|안동의 대표 이색체험
안동 지역 열대 과일 파파야 자라다|열대과일 파파야, 안동에서도 자라고 있어요.
보통 때 아이 직접 경험 어렵다 새롭다 경험 원하다 만약?|아이들이 평소에 접해보지 못한 새로운 체험을 찾는다면,
문화 도시 안동 지역 파파야 농장 체험 역사 미래 합 경험 가능|역사와 미래가 공존하는 문화도시 안동에서 파파야 농장 체험을 해 보세요.
선비순례길|선비순례길
물 걷다 느끼다|물 위를 걷는 느낌
자연 깨끗하다 길 곳 안동호 멋있다 구경 또 유교 문화 다양 즐기다 가능|안동호의 절경과 다양한 유교 문화 유적을 함께 즐길 수 있는 자연 친화적인 탐방로,
안동 선비 순례길 구경 때 물 걷다 가능 길 직접 걷다 기분 즐기다 좋다|안동 선비 순례길 코스 내에 물 위를 걸을 수 있는 선성수상길은 천천히 걸어보는 것만으로도 힐링이 될 산책로입니다.
예끼 마을|예끼마을
재능 많다 기준 좋다 여행 곳|”끼”많은 힐링 여행지
예술 사람 재능 많다 곳 이름 예끼 마을 음악 그림 가득 있다 곳|예술인의 끼가 가득한 마을, 예끼마을은 음악과 그림, 문학이 가득한 정겨운 마을이에요.
곳곳 아름답다 벽화 또 공방 다양 보다 추억 즐기다 좋다|곳곳에 그려져 있는 아름다운 벽화와 다양한 공방들을 둘러보는 것 만으로도 즐거운 추억을 만들 수 있답니다.
차 돕다 타다 출발|픽업 및 이동
곳 따르다 다르다|위치에 따라 상이
결정 곳 차 돕다 타다 후 안동 출발|지정된 장소에서 픽업 후 안동으로 이동
점심 식사|점심식사
1시간 아마|1시간 소요 예정
여행 지역 곳 방식 식사|현지식 식사
하회 마을|하회마을
1시간 아마|1시간 소요 예정
전통 가득 하회 마을 구경 보다|전통이 가득한 하회마을 둘러보기
탈 만들다 체험|탈만들기 체험
1시간 15분 아마|1시간 15분 소요 예정
탈 직접 만들다 체험|나만의 탈 직접 만들어보기
월영교|월영교
30분 어머|30분 소요 예정
월영교 곳 밤 모습 보다|월영교 야경 감상하기
2일차|2일차
아침 식사|아침식사
오전 8:00시 아마|오전 8:00시 예정
호텔 조식 식사|호텔조식 식사
월영교|월영교
30분 아마|30분 소요 예정
오전 월영교 모습 보다|오전에 감상해보는 월영교의 모습
파파야 농장|파파야 농장
1시간 아마|1시간 소요 예정
보통 때 직접 경험 어렵다 파파야 농장 체험 가능|평소에 접해보기 어려웠던 열대과일인 파파야 농장 체험하기
점심 식사|점심식사
1시간 아마|1시간 소요 예정
여행 지역 곳 방식 식사|현지식 식사
장부당|장부당
1시간 소요 예정|1시간 소요 예정
예술 사람 많다 마을 보다 카페 곳 커피 마시다 휴식|예술인의 끼가 가득한 마을을 보며 카페에서 휴식
차 돕다 내리다 해산|드랍오프 및 해산
곳 따르다 다르다|위치에 따라 상이
차 운전 안전 집 도착|집으로 안전하게 차량 이동
담당자|담당자
부장 김찬중|부장 김찬중
어린이 보호 여행 창의력 향상 또 자아 탐색 돕다 있다|어린이 돌봄 여행 코스는 창의력 향상과 자아 탐색에 도움이 될 수 있도록 구성하였으며
또 아이 보호 전문 사람 인솔|전문 돌봄이가 아이들을 인솔할 예정입니다.
어르신 보호 여행 활동 강도 힘들다 아니다 모두 여행 즐기다 가능|또한 어르신 돌봄 여행 코스는 활동 강도가 높지 않아서 누구나 여행을 즐길 수 있도록 구성하였습니다.
상담 자세하다 원하다 사람 02-719-6811 연락 부탁|자세한 상담을 원하시는 분들은 02-719-6811으로 문의 바랍니다.
울릉도 깨끗하다 곳 구경 또 맛있다 음식 먹다 여행|청정 자연에서 즐기는 울릉도 미식 여행
울릉도 곳 여행 사람 인 중|여행객들 사이에 뜨고 있는 울릉도 여행!
지금 해외 여행 어렵다 대신 한국 여행 특히 섬 여행 관심 증가 중|해외여행이 어려워진 요즘, 국내 여행, 특히 섬 여행에 대한 관심이 증가하고 있습니다.
아이 함께 울릉도 가족 여행 가다|아이와 함께 울릉도로 가족 여행을 떠나보세요!
을릉도 곳 아름답다 있다 울릉 10경, 또 울릉도 특별 음식 따개비 칼국수, 산채 비빔밥|울릉도의 아름다움을 품고 있는 울릉 10경, 따개비 칼국수, 산채 비빔밥 등의 각종 울릉도만의 특식!
다르다 나라 여행 느끼다 비슷 섬|마치 해외에 온 듯한 이국적 풍경을 간직한 신비의 섬,
울릉도 곳만 생기다 음식 먹다 가능|울릉도에서 현지에서만 맛볼 수 있는 향토 음식을 즐겨보세요!
어뮤즈트래블 아이 보호 여행 특별 돕다 6가지|어뮤즈트래블 아이 돌봄 여행의 6가지 특전 서비스
1. 전용 차 돕다 타다 독하다 약 뿌리다 있다 코로나 걱정 불필요|1. 프라이빗 픽업서 비스 코로나 걱정 없이 철저한 소독 후 이용
2. 고급 맞추다 돕다 집 앞 만나다 차 타다, 알러지 확인 이후 간식 또 밥 제공|2. 맞춤 프리미엄 서비스 집 앞 픽업, 알러지 체크 후 간식 및 식사 제공
3. 동시 다르다 곳 둘 여행 가족 각자 여행 곳 분리 손님 만족 크다 또 시간 절약|3. 동시에 2코스 진행 가족 별 일정을 나누어 고객 만족 & 시간 활용도 UP
4. 코로나 막다 안전 여행 병 막다 관리 법 순종, 안전캠 기록 시간 계속 곳 무엇 확인 또 연락|4. 코로나 안전 여행 방역 수칙 준수, 안전캠 기록 실시간 위치 추적 & 연락
5. 인솔 사람 믿음 운전, 인솔, 스냅 사진 찍다 전문 사람 함께 붙다 가다|5. 믿음직한 인솔자 운전, 인솔, 스냅사진 촬영 내부 직원 최소 1인 동행
6. 보호 돕다 어린이, 노인 합 가족 모두 여행 즐기다|6. 돌봄 서비스 어린이, 노인 동반 가족 구성원 모두 즐거운 여행
여행 가다 어렵다 울릉도 여행 아이 보호 여행 함께 다르다 이유 무엇?|쉽게 떠나기 힘든 울릉도 여행을 아이 돌봄 여행과 함께 하면 다른 이유!
다르다 곳 둘 여행 곳 포함 모두 여행 시간|2코스 일정을 포함한 Full코스 일정!
여행 때 아이 또 보호 사람 모두 맞추다 구경 여행 즐기다|여행 중에 아이와 보호자 모두가 즐길 수 있는 별도의 맞춤형 코스 진행해요!
먹다/숙소/차량 모두 포함 있다|식사/숙소/차량 모두 포함된 투어!
호텔 비슷 숙소, 여행 때 모두 먹다 시간 있다, 차 모두 포함 여행 200% 즐기다 가능|호텔 급 숙소, 전 일정 식사, 차량 모두 포함되어 여행을 200% 즐길 수 있어요!
인도 사람 길 인도만 아니다|길잡이 가이드만 있는 여행은 NO!
인솔 사람 함께 계속 붙다 여행 빠지다 없다 모두 구경 여행 가능|인솔자가 항상 함께하여 여행지의 작은 부분 하나까지 놓치지 않고 여행할 수 있어요!
여행 사람 최소 출발 사람 수 4명 (최대 6명)|여행 인원 최소 출발 인원 4인 (최대 6인)
어린이 안전 위하다 예약 가능 사람 수 4명|어린이는 안전을 위해 최대 4명까지 예약 가능
-기본 옵션|-기본 옵션
어린이 (평일/주말) 1명 당 584,000원|어린이 (평일/주말) 1명 당 584,000원
어른 (평일/주말) 1명 당 678,000원|어른 (평일/주말) 1명 당 678,000원
포함 사항 울릉도 왕복 페리, 현지 인솔, 아이 보호 돕다, 입장 또 체험비, 계획 중 식사/숙소, 여행 사람 보험|포함사항 울릉도 왕복 페리, 현지 인솔, 아이 돌봄 서비스, 입장 및 체험비, 일정 중 식사/숙소, 여행자 보험
불포함 사항 강륵여객 터미널 (모이다 곳) 교통비, 기타 개인 경비|불포함 사항 강릉여객터미널(집결지)로의 교통비, 기타 개인경비
첫번째 날 하루 계획 울릉도 여행 여유 출발|1일차 일정 여유롭게 시작해보는 울릉도 여행
저동항 점심 식사 내수선 일출 전망대 관음도 석포 일출 일몰 전망대 저녁 식사 숙소 곳 출발|저동항-점심식사-내수전 일출 전망대-관음도-석포 일출 일몰 전망대-저녁식사-숙소로 이동
<함께 여행 곳>|<공통코스>
동해 바다 해 뜨다 멋있다, 내수선 일충 전망대 (1시간 아마)|동해바다 해돋이의 장관, 내수전 일출전망대 (1시간 소요 예정)
동해 바다 곳 해 뜨다 멋있다 보다 가능 곳|동해바다의 웅장한 해돋이를 볼 수 있는 전망대!
오르다 길 곳 정상 까지 동백 나무 또 마가목 가득 보다 가능|오름길에 수많은 동백나무와 마가목 등이 가득하여 초록초록한 자연을 느끼며 정상까지 갈 수 있습니다.
내수전 전망대 곳 울릉도 전체 보다 가능|내수전 전망대에서 울릉도의 파노라마뷰를 감상해봐요!
생태 식물 많다 곳 관음도 (1시간 30분 아마)|생태식물의 천국, 관음도 (1시간 30분 소요 예정)
관음도 곳 식물 넘치다 또 자연 보호! 혼자 생기다 식물 또 깨끗 숲 유명하다 곳|야생식물의 천국이자 생태자연의 보존지인 관음도! 수많은 울릉도 자생식물들과
모습 그대로 잘 유지 때문 구경 신기하다 많다|지질명소로 등재되어 있는 관음도는 원시림 그대로의 모습을 잘 간직하고 있어 색다른 볼거리를 제공합니다.
풍광 바다 또 바다 섬 어울리다 곳, 석포 일출 일몰 전망대 (50분 아마)|바다와 바다섬이 어우러진 풍광, 석포 일출일몰 전망대 (50분 소요 예정)
전망대 울릉도 북동쪽 곳 있다 울릉도 해상 3대 멋있다 구경 가능|울릉도의 북동쪽에 위치한 전망대로 울릉도 해상 3대 비경을 한눈에 볼 수 있습니다.
전망대 앞 죽도 곳 만약 날씨 맑다 독도 보다 가능 또 일몰 일출 보다 가능|전망대에선 앞에 죽도가 맑은 날엔 독도까지 관찰할 수 있고 일출과 일몰 둘다 볼 수 있습니다.
두번째 날 계획 울릉도 아름답다 보다|2일차 일정 아름다운 울릉도를 눈에 담아요
아침 식사 태하항목 모노레일 현포항 나리분지 점심 시간|아침식사-태하향목 모노레일-현포항-나리분지-점심식사
어린이 여행 곳 천부 해수욕장 / 어른 여행 곳 카페 울라 저녁 식사 시간 자유|-어린이코스:천부 해수욕장/어른 코스 카페 울라저녁식사-자유시간
<함께 여행 곳>|<공통코스>
울릉도 가운데 가장 멋있다 곳, 태하향목 모노레일 (1시간 아마)|울릉도 최고의 절경, 태하향목 모노레일 (1시간 소요 예정)
모노레일 타다 오르다 기암 또 향 나무 소나무 보다 가능|모노레일을 타고 올라가면서 기암과 향나무 소나무를 보며 자연을 감상할 수 있습니다.
태하 전망대 도착 대풍감 우리 나라 10대 멋있다 곳 보다 가능|태하전망대에 도착하면 우리나라의 10대 비경 중 하나인 대풍감을 볼 수 있습니다.
아름답다 북면 해안, 현포항 (30분 아마)|아름다운 북면 해안, 현포항 (30분 소요 예정)
아름답다 울릉도 북쪽 바다 보다 가능 곳|아름다운 울릉도의 북쪽 바다를 볼 수 있는 장소입니다.
형포 전망대 곳 보다 다르다 나라 가다 느끼다 가능|현포 전망대에서 바라보는 전경은 이국적인 느낌을 주며 마치 해외에 온듯한 기분을 느끼게 해줍니다.
울릉도 가운데 유일하다 평평 곳, 나리분지(15분 아마)|울릉도의 유일한 평야, 나리분지 (15분 소요예정)
나리 분지 울릉도 가운데 유일하다 평평 곳 바다 길이 약 500m 있다 때문 물 고이다 없다|울릉도의 유일한 평야 나리분지! 해발 약 500m에 위치한 나리분지는 물이 고이지 않고
물 땅 스며들다 밭농사 있다|지하수로 스며들어 밭농사를 주된 농업으로 하고 있습니다.
예전 선조 살다 투막집 너와집 보다 가능|옛날 선조들의 삶의 터전이던 이곳에선 투막집과 너와집 등도 만나볼 수 있습니다.
(어린이 여행 곳)|(어린이 코스)
맑다 물 곳 물 놀다, 청부항 해수풀장(2시간 아마)|맑은 물에서 신나는 물놀이, 천부항 해수폴장 (2시간 소요 예정)
울릉도 방문 꼭 물 놀다 필요|울릉도에 오면 반드시 즐기고 가야 하는 물놀이!
청부 바다 물 놀다 즐기다 좋다|천부해수욕장에서 신나는 물놀이를 즐겨봐요.
물 놀다 중 천부해중 전망대 곳 바다 10m 아래 보다 가능|물놀이를 하다가 천부해중전망대에서 10m 바다 밑 세계도 구경할 수 있습니다.
(어른 여행 곳)|(어른 코스)
울릉도 가장 인기 많다 곳 카페 울라 (2시간 아마)|울릉도 최고의 핫플레이스, 카페 울라(2시간 소요 예정)
코스모스링 꾸미다 만들다 물건 또 메가 울라 있다 일몰 때 하늘 색 붉다 보다 가능|코스모스링 조형물과 메가 울라와 함께 일몰 때 붉게 물드는 아름다운 울릉도를 담아보세요!
일몰 보다 기분 즐기다 가능 가장 좋다 곳|일몰 분위기를 만끽할 수 있는 최고의 장소입니다.
세번째 날 계획 소중하다 땅 자연 배우다|3일차 일정 우리의 소중한 땅과 자연을 알아봐요
아침식사 어린이 여행 곳 독도 박물관 또 케이블카 /|아침식사어린이코스 독도박물관&케이블카/
어른 여행 곳 행남 바다 산책 길 점심 식사 봉래 폭포 선착장 가다|어른코스:행남해안산책로-점심식사-봉래폭포-선착장 이동
(어린이 여행 곳)|(어린이코스)
역사 또 멋있다 구경 가능 독도 케이블카&독도 박물관 (2시간 아마)|역사와 파노라마뷰를 한번에, 독도 케이블카&독도 박물관(2시간 소요 예정)
케이블카 타다 전망대 독도항 구경 가능|독도항을 한 눈에 볼 수 있는 멋진 뷰를 볼 수 있는 전망대까지 케이블카를 타고 가볼 수 있습니다.
날씨 좋다 날 독도 보다 가능|날씨가 좋은 날엔 독도도 볼 수 있다고 합니다.
케이블카 타다 내리다 대한민국 유일 독도 박물관 구경 모르다 새롭다 배우다|케이블카를 타고 내려와 대한민국 유일의 영토 박물관인 독도 박물관을 둘러보며 몰랐던 아름다운 우리 땅을 알아봐요!
(어른 여행 곳)|(어른코스)
옥빛 바다 산책, 행남 해안 산책 길 (2시간 아마)|옥 빛 바다 산책, 행남 해안 산책로 (2시간 소요 예정)
행남 해안 산책 길 신 직접 만들다 이야기 정도 멋있다 유명하다 곳|신이 빚은 작품이라 불리는 국가 지질 공원의 지질 명소 중 하나인 행남 해안 산책로!
해안 멋있다 아릅답다 또 색 에메랄드 빛 바다 보다 가능|그만큼 해안 비경이 아름답고 옥색 에메랄드 빛 바다를 만날 수 있습니다.
<공통 여행 곳>|<공통코스>
폭포 사계절 계속 아릅답다, 봉래 폭포 (1시간 아마)|사계절 내내 아름다운 폭포, 봉래폭포 (1시간 소요 예정)
높이 30m 폭포 3단 물 충분 많다 1년 계속 보다 가능 울릉도 살다 사람 물 마시다 가능 돕다 곳|높이 30m의 3단 폭포로 수량이 풍부해 1년 내내 볼 수 있고 울릉도민의 소중한 식수원입니다.
여름 덥다 때 계속 물 차갑다 유지 때문 자연 에어컨 같다 시원 바람 또 자연 그대로 곳 삼나무 숲 보다 가능|한여름에도 서늘한 냉기를 유지해 천연 에어컨이라 불리는 풍혈과 잘 보존된 원시림인 삼나무 숲까지 함께 만나볼 수 있습니다!
지역 상황 따르다 계획 변경 가능 아마|*상기 일정은 현지 사정에 따라 변동될 수 있습니다.
<보호 여행 곳>|<돌봄코스>
1일차 날|1일차
강릉 여객 터미널 모이다 오전 7시 30분|강릉 여객터미널 집결 오전 7시 30분
설명 내용 이야기 또 페리 승선|안내사항 전달 및 페리 승선
점심 시간|점심식사
1시간 아마|1시간 소요 예정
해물 백짬뽕 (먹다 변경 가능 아마)|해물 백짬뽕 (메뉴는 변경될 수 있음)
내수전 일출 전망대|내수전 일출전망대
1시간 아마|1시간 소요 예정
울릉도 깨끗 숲 보다 걷다 구경|울릉도의 원시림을 즐기며 가벼운 산책
관음도|관음도
1시간 30분 아마설명 내용 이야기 또 페리 승선|1시간 30분 소요 예정
산 오르다 관음도 구경 보다|울릉4경인 관음도 둘러보며 트레킹
석포일출일물전망대|석포일출일몰전망대
50분 아마|50분 소요 예정
전망대 일몰 구경 여행|전망대 일몰관광
저녁 식사|저녁 식사
1시간 아마|1시간 소요 예정
여행 지역 곳 방식 식사|현지식 식사
숙소 곳 출발|숙소로 이동
다온 프라임 호텔 또 동급 리조트 (2인 1실 기준)|다온프라임호텔 혹은 동급 리조트 (2인 1실 기준)
2일차 날|2일차
아침 식사|아침식사
오전 8시 아마|오전 8시 예정
호텔 조식 아니다 만약 여행 지역 곳 방식 식사|호텔 조식 또는 현지식
통구미 거북 바위|통구미 거북 바위
10분 아마|10분 소요 예정
통구미 거북 바위 곳 기념 사진|통구미 거북바위 기념촬영
태하향목 모노레일|태하향목모노레일
1시간 30분 아마|1시간 30분 소요 예정
모노레일 타다 이후 태하 전망대 구경 여행|모노레일 탑승 후 태하 전망대 관광
현포항|현포항
30분 아마|30분 소요 예정
현포항 구경 보다 기념 사진|현포항 둘러보며 기념 촬영
나리분지|나리분지
30분 아마|30분 소요 예정
나리분지 울릉도 곳 유일하다 평지 움집 구경 보다|울릉도의 유일한 평지, 나리분지와 움집 둘러보기
점심 식사|점심식사
1시간 아마|1시간 소요 예정
산채 비빔밥 (먹다 변경 가능 아마)|산채비빔밥 (메뉴는 변경될 수 있음)
천부 해수욕장|천부 해수욕장
2시간 아마|2시간 소요 예정
바다 수영장 곳 물 놀다|해수풀장에서 물놀이하기
저녁 식사|저녁 식사
1시간 아마|1시간 소요 예정
여행 지역 곳 방식 식사|현지식 식사
숙소 곳 가다|숙소로 이동
다온 프라임 호텔 또 동급 리조트 (2인 1실 기준)|다온프라임호텔 혹은 동급 리조트 (2인 1실 기준)
3일차 날|3일차
아침 식사|아침식사
오전 8시 예정|오전 8시 예정
호텔 조식 또는 현지식|호텔 조식 또는 현지식
독도 박물관 & 일출 전망대 케이블카|독도박물관 & 일출전망대 케이블카
1시간 30분 아마|1시간 30분 소요 예정
독도 관련하다 역사 설명 이야기 또 케이블카 타다|독도에 대한 역사 설명 및 케이블카 탑승
봉래 폭포|봉래폭포
1시간 아마|1시간 소요 예정
봉래폭포 구경 여행 또 기념 사진|봉래폭포 관광 및 기념촬영
점심 식사|점심식사
1시간 아마|1시간 소요 예정
여행 지역 곳 방식 식사|현지식 식사
선착장 곳 이동|선착장으로 이동
페리 타다 강릉 출발|강릉으로 향하는 페리 탑승
<보호 사람 여행 곳>|<보호자코스>
1일차 날|1일차
강릉 여객 터미널 모이다|강릉 여객터미널 집결
오전 7시 30분|오전 7시 30분
알리다 내용 이야기 또 페리 승선|안내사항 전달 및 페리 승선
점심식사|점심식사
1시간 아마|1시간 소요 예정
해물 백짬뽕 (먹다 변경 가능 아마)|해물 백짬뽕 (메뉴는 변경될 수 있음)
내수전 일출 전망대|내수전 일출전망대
1시간 아마|1시간 소요 예정
울릉도 깨끗 숲 보다 걷다 구경|울릉도의 원시림을 즐기며 가벼운 산책
관음도|관음도
1시간 30분 아마|1시간 30분 소요 예정
산 오르다 관음도 구경 보다|울릉4경인 관음도 둘러보며 트레킹
석포일출일물전망대|석포일출일몰전망대
50분 아마|50분 소요 예정
전망대 일몰 구경 여행|전망대 일몰관광
저녁 식사|저녁식사
1시간 아마|1시간 소요 예정
여행 지역 곳 방식 식사|현지식 식사
숙소로 이동|숙소로 이동
다온 프라임 호텔 또 동급 리조트 (2인 1실 기준)|다온프라임호텔 혹은 동급 리조트 (2인 1실 기준)
2일차 날|2일차
아침 식사|아침식사
오전 8시 아마|오전 8시 예정
호텔 조식 아니다 만약 여행 지역 곳 방식 식사|호텔 조식 또는 현지식
통구미 거북바위|통구미 거북바위
10분 아마|10분 소요 예정
통구미 거북 바위 곳 기념 사진|통구미 거북바위 기념촬영
태하향목 모노레일|태하향목모노레일
1시간 30분 아마|1시간 30분 소요 예정
모노레일 타다 이후 태하 전망대 구경 여행|모노레일 탑승 후 태하전망대 관광
현포항|현포항
30분 아마|30분 소요 예정
현포항 구경 보다 기념 사진|현포항 둘러보며 기념촬영
나리분지|나리분지
30분 아마|30분 소요 예정
나리분지 울릉도 곳 유일하다 평지 움집 구경 보다|울릉도의 유일한 평지, 나리분지와 움집 둘러보기
점심식사|점심식사
1시간 아마|1시간 소요 예정
산채 비빔밥 (먹다 변경 가능 아마)|산채비빔밥 (메뉴는 변경될 수 있음)
카페 이름 울라|카페 울라
2시간 아마|2시간 소요 예정
카페 곳 휴식 만들다 물건 기념 사진 가능 또 일몰 보다|카페에서 여유롭게 휴식하며 조형작품과 기념촬영 및 일몰감상
저녁식사|저녁식사
1시간 아마|1시간 소요 예정
여행 지역 곳 방식 식사|현지식 식사
숙소 곳 가다|숙소로 이동
다온 프라임 호텔 또 동급 리조트 (2인 1실 기준)|다온프라임호텔 혹은 동급 리조트 (2인 1실 기준)
3일차|3일차
아침식사|아침식사
오전 8시 예정|오전 8시 예정
호텔 조식 또는 현지식|호텔 조식 또는 현지식
행남 해안 걷다 길|행남해안산책로
1시간 30분 아마|1시간 30분 소요 예정
울릉도 바다 구경 바다 길 걷다|해안산책로 걸으며 울릉도 바다 감상
봉래 폭포|봉래폭포
1시간 아마|1시간 소요 예정
봉래폭포 구경 여행 또 기념 사진|봉래폭포 관광 및 기념촬영
점심 식사|점심식사
1시간 아마|1시간 소요 예정
여행 지역 곳 방식 식사|현지식 식사
선착장 곳 이동|선착장으로 이동
페리 타다 강릉 출발|강릉으로 향하는 페리 탑승
<포함사항>|<포함사항>
숙박 3 성급 호텔/리조트|숙박 3 성급 호텔/리조트
교통/기사 승합차, 선박|교통/기사 승합차, 선박
식사 여행 지역 곳 방식  (전일정)|식사 현지식 (전일정)
티켓 입장권 전체 포함, 체험비 전체 포함|티켓 입장권 전체 포함, 체험비 전체 포함
인도 사람  운전 인도 사람 (전체 일정)|가이드 드라이빙 가이드 동행 (전체일정)
기타 돕다 여행 사람 보험|기타서비스 여행자보험
기차 길 자전거 바다 곳 가장 가깝다 있다|바다에서 가장 가까운 레일 바이크,
강릉 바다 바람 시원 구경 여행 가능|시원한 바닷바람과 함께 하는 강릉 나들이
보통 생활 반복 힘들다 피곤 여행 가다 힘 세우다 즐기다 좋다 곳 무엇?|반복되는 일상에 지쳐 있는 요즈음, 다시 활력을 불러줄 가볍고 시원한 여행, 어디없을까요?
강릉 곳 오다|강릉으로 오세요!
기차 길 바이크 시원 바람 좋다 또 주문진 시장 곳 바다 물고기 오징어 여러가지 새롭다 깨끗 보다|레일 바이크를 타고 느끼는 시원한 바닷바람과 싱싱한 해산물이 가득한 주문진 시장의 활력 넘치는 모습으로,
영향 힘 세우다 가능|지쳐 있는 일상에 다시 활력을 불어 넣어 드려요!
어뮤즈 트래블 나이 많다 사람 맞추다 특별 돕다 5가지|어뮤즈 트래블 시니어 맞춤 여행의 5가지 특전 서비스
다르다 곳 다르다 각자 맞추다 돕다|차별화된 맞춤 서비스
사람 각자 상황 또 원 맞추다 돕다|고객별 상황 및 니즈에 맞는 개별 맞춤 서비스
알러지 또 사람 각자 안 맞추다 음식 확인 후 간식 또 식사 제공|알러지 등 고객 특이사항 체크 후 간식 및 식사 제공
어르신 맞추다 계획|어르신 맞춤 일정
힘 또 취향 맞추다 계획 만들다 손님 만족 크다|체력과 취향을 반영한 일정으로 고객 만족도 UP
전문 인솔 사람 믿음 가능|믿음직한 전문 인솔자
운전, 인솔, 스냅 사진, 일 사람 1인 이상 동행|운전, 인솔, 스냅 사진 촬영, 내부 직원 최소 1인 동행
보호 돕다|돌봄 서비스
나이 많다 사람 자세하다 관리 보호 돕다 있다 모두 만족 여행|세심한 돌봄 서비스로 시니어 동반 일행 모두가 즐거운 여행
전용 차 돕다 타다|프라이빗 픽업서비스
집 앞 차 돕다 타다|철저한 소독 후 프라이빗 차량이용
차 독하다 약 뿌리다 깨끗 코로나 걱정 불필요|집앞 픽업 서비스
기본 옵션|기본 옵션
가격 평일/주말 1인 당 154,000원|가격 평일/주말 1인당 154,000원
(포함 사항)|(포함사항)
차 돕다 타다 (수도권 기준)|단독 차량 픽업서비스(수도권 기준)
운전 사람 또 인솔 사람|기사 및 인솔자
입장 및 체험비|입장 및 체험비
식사 2회|식사 2회
여행 사람 보험|여행자 보험
(불포함 사항)|(불포함사항)
기타 개인 경비|기타 개인경비
(여행인원)|(여행인원)
최소 출발 인원 4인 (최대 6인)|최소 출발인원 4인 (최대 6인)
강릉 여행 걱정 버리다|근심 날리는 강릉 당일여행!
출발 오전 7시 30뷴 서울 결정 곳|출발 오전 7시 30분 서울 내 선택장소
강릉 출발 > 오죽헌 > 점심 식사 > 정도진 기차 길 자전거 > 정동진 바다 > 주문진 수산 시장 >|강릉으로 이동 > 오죽헌 > 점심식사> 정동진 레일바이크 > 정동진 해수욕장 > 주문진 수산시장 >
저녁 식사 > 집 출발|저녁식사 > 집으로 이동
도착 오후 10시 서울 결정 곳|도착 오후 10시 서울 내 선택장소
도로 또 여행 지역 곳 상황 따르다 계획 변경 가능 아마|상기 시간표는 도로 및 현지 사정에 의하여 다소 변경될 수 있습니다.
하루 여행|데이투어
오죽헌 제 165호 보물, 율곡이이 태어나다 곳|오죽헌 보물 제 165호, 율곡이이가 태어난 곳
오죽헌 곳 신사임당 이율곡 태어나다 자라다 곳 강릉 역사 또 문화 보다 가능|오죽헌은 신사임당과 이율곡이 나고 자란 곳으로 강릉의 역사와 문화를 보여주는 명소입니다.
오죽헌 이름 의미 무엇? 집 주변 검다 대나무 숲 넓다|집 주위에 검은 대나무 숲이 울창하다는 뜻에서 유래한 이름을 갖고 있습니다.
역사 추억 있다 곳 꼭 구경 부탁|역사와 추억이 묻어있는 장소를 놓치지 말고 둘러보세요.
생선 구이 정식 맛있다 생선 구이 또 반찬 깔끔하다|생선구이 정식 고소한 생선구이와 정갈한 밑반찬
구경 여행 출발 전 먹다 배부르다 꼭 필요|투어를 본걱적으로 시작하기 전, 든든한 한끼는 필수!
생선 겉 딱딱 속 부드럽다 굽다 또 정성 준비 반찬 먹다 가능|겉은 바삭, 속은 촉촉하게 구운 생선과 함께 정성스럽게 준비한 한상으로 든든한 식사를 챙겨드려요.
정문진 기차 길 자전거 바다 아름답다 구경 가능|정동진 레일 바이크 아름다운 바다 경치를 감상할 수 있어요
한국 중 일출 일몰 가장 아름답다 곳|대한민국에서 일출과 일몰이 가장 아름당운 곳,
정동 곳 기차 길 자전거 타다 바다 바람 시원 즐기다 추억 해보다 부탁|‘정동’에서 추억과 낭만이 어우러지는 레일바이크를 타며 시원한 바닷 바람을 느껴보세요.
아름답다 깨끗 바다 보다 추억 행복 가능|아름답고 눈부신 청정 바다와 함께 행복한 추억을 만들 수 있는 곳입니다.
정동진 해수욕장 동해 눈 보다 아름답다 유명하다 곳|정동진 해수욕장 탁 트인 전경이 아름다운 동해 명소
정동진 파랗다 바다 또 파도 강하다 있다 한국 대표 유명하다 곳|푸른 바다와 거친 파도를 가진 정동진은 대한민국 최고의 바다 명소입니다.
정동진 바다 가다 커피 마시다 스트레스 쌓이다 마음 답답 풀리다 부탁|그동안 쌓인 스트레스와 답답했던 마음을 정동진 해수욕장에서 커피한잔과 함께 천천히 풀어보아요.
주문진 수산시장 재래시장 1936년부터 계속|주문진 수산시장 1936년부터 형성된 재래시장
재래시장 1936년부터 계속 여기 곳  종합 시장, 건어물 시장. 회 센터 포함 있다|1936년부터 형성된 재래시장으로 종합시장, 건어물시장, 회 센터 등을 포함한 다양한 형태의 상가와 연계되어있습니다.
수산 시장 항상 활동 힘 또 새롭다 깨끗 물고기 많다|싱싱한 해산물이 가득하고 언제나 활력이 넘치는 수산시장이에요.
다양 회 반찬 바다 향 있다 깨끗 반찬|모둠회 정식 바다 향기 가득 담은 신선한 한끼
바다 방문 꼭 먹다 필요|바다에 왔으면 한 번은 꼭 먹고 가셔야죠!
주문진 수산 시장 곳 새롭다 깨끗 물고기 또 다양 회 반찬 먹다 즐기다 부탁|주문진 수산시장에서 신선한 해산물, 다양한 반찬과 함께 제공되는 모둠 회 정식을 즐겨보세요!
1일차 날|1일차
차 돕다 타다 곳 모이다 다음 설명|픽업 장소 집결 및 안내
오전 7시 30분 아마|오전 7시 30분 예정
손님 결정 차 돕다 타다 곳 모이다 때 계획 설명 이후 강릉 출발 (휴게소 1회 경유)|고객님이 선택한 픽업장소 앞에서 집결하여 일정 안내 후 강릉 출발 (휴게소 1회 경유)
오죽헌|오죽헌
1시간 소요 아마|1시간 소요 예정
오죽헌 구경 여행|오죽헌 관람
점심식사|점심식사
1시간 아마|1시간 소요 예정
생선 굽다 (먹다 변경 가능 아마)|생선구이 (메뉴는 변경될 수 있습니다.)
정동진 기차 길 자전거|정동진 레일바이크
1시간 아마|1시간 소요 예정
정동진 기차 길 자전거 탑승|정동진레일바이크 탑승
정동진 바다|정동진 해수욕장
2시간 아마|2시간 소요 예정
바다 구경 건다 또 커피 마시다|해수욕장 산책 및 티타임
주문진 수산 시장|주문진수산시장
1시간 아마|1시간 소요 예정
지역 특별 물건 시장 구경 또 사다|특산물 시장 구경 및 쇼핑
저녁 식사|저녁식사
1시간 30분 아마|1시간 30분 소요 예정
다양 회 (먹다 변경 가능 아마)|모듬 회 (메뉴는 변경될 수 있습니다.)
집 돌아가다|귀가
오후 7시 아마|오후 7시 예정
여행 끝 이후 집 출발|투어가 종료 된 후 집으로 이동
자연 있다 피로 회복|자연 속에서 피로회복!
강릉 곳 호텔 쉬다|강릉 호캉스 떠나볼까요?
요즘 밖 활동 못하다 집 있다 오래 답답 맞다?|외출이 어려워진 요즘, 집에 머무는 시간이 길어져 많이 답답하셨죠?
호텔 조식 뷔폐 다양 음식 있다|하루 정도는 다양한 메뉴가 준비되어있는 호텔의 조식뷔페,
또 밖 바다 보다 물 빠지다 목욕 가능|바다가 보이는 창밖을 바라보며 즐기는 온천욕,
고급 화려하다 저녁 뷔폐 먹다 가능 호텔 쉬다 여행 하루 가다 해보다|럭셔리한 석식 뷔페를 모두 즐길 수 있는 호캉스를 떠나보시는 건 어떠세요?
어뮤즈 준비 무엇? 보통 생활 피곤 호텔 쉬다 여행 힘 세우다 돕다|지친 일상에 활력을 가져다줄 힐링 호캉스! 어뮤즈가 준비했습니다.
(기본 선택)|(기본옵션)
평일 1인당 458,000원|평일 1인당 458,000원
주말 1인당 509,000원|주말 1인당 509,000원
(포함 사항)|(포함사항)
차 돕다 타다 (수도권 기준)|단독 차량 픽업서비스(수도권 기준)
운전 사람 또 인솔 사람|기사 및 인솔자
입장 및 체험비|입장 및 체험비
식사 4회|식사 4회
여행 사람 보험|여행자 보험
(불포함 사항)||(불포함사항)
기타 개인 경비|기타 개인경비
(여행인원)|(여행인원)
최소 출발 인원 4인 (최대 6인)|최소 출발인원 4인 (최대 6인)
<1일차>|<1일차>
월정사 오대산 깊다 곳 있다|월정사 오대산 깊은 곳에 자리 잡은 곳
오대산 국립 공원 곳 강원도 평창 있다|강원도 평창에 자리한 오대산 국립공원.
월정사 전나무 숲 걷다 기분 좋다 2011년 때 전국 아름답다 숲 가운데 크다 상 받다 경험|월정사 전나무 숲은 2011년 아름다운 전국 숲 대회에서 대상을 수상한 걷기 좋고 힐링 하기 좋은 아름다운 숲입니다.
길 평지 쭉 걷다 편하다 때문 남자 여자 노인 아이 상관 없다 모두 방문 곳|걷기 편하도록 길이 잘 다듬어져 있어 남녀노소 구분 없이 많이들 찾는 장소랍니다.
산채백반 다양 나물 먹다 건강 맛있다|산채백반 다양한 나물과 함께, 건강하고 맛있는 식사
산채백반 다양 나물 짜다 없다 맛 약하다 향 나다 맛있다 먹다 가능 곳|자극적이지 않고 간이 세지 않아 다양한 나물의 향과 맛을 느낄 수 있는 산채백반입니다.
하얀 쌀밥 다양 나물 고추장 넣다 비비다 먹다 속 편하다 맛있다|하얀 쌀밥과 여러 종류의 산채 나물을 반찬으로 함께 준비된 양념 고추장에 비벼먹으면 속이 편안한고 맛있는 한끼가 뚝딱!
발왕산 케이블카 하늘 날다 기분 비슷 가능|발왕산 케이블카 하늘을 날아오르는 듯한 기분을 느껴보세요
용평 발왕산 관광 케이블카 길이 왕복 7.4km 국내 가장 길다 곳 산 정산 도착 시간 18분|왕복 7.4km 국내 최대 길이의 용평 발왕산 관광 케이블카는 발왕산 정상에 이르는 18분 동안,
그동안 하늘 날다 기분 비슷 또 산 바다 보다 가능|하늘을 날아오르는 듯한 유유한 멋과 싱그러운 자연의 정취를 느낄 수 있어요.
구경 보다 편하다 여유 해보다 부탁|여유롭고 편안하게 멋진 풍경을 감상해보세요.
호텔 탑스텐 석식 호텔 곳 편안 고급 화려 저녁 식사|호텔 탑스텐 석식 편안하고 럭셔리하게 즐겨보는 저녁 식사
호텔 뷔페 식당 곳 특별 높다 요리 사람 직접 정성|특급 셰프들이 정성으로 만든 다양한 요리로 진정한 음식의 품격과 가치를 느낄 수 있는
요리 고급 만들다 먹다 해보다 부탁|호텔 뷔페 레스토랑에서 맛의 향연을 즐겨보세요!
<2일차>|<2일차>
호텔 탑스틴 조식  아침 눈 뜨다 바다 보다 여유|호텔 탑스텐 조식 바다를 바라보며 여유로운 아침 맞이하기
호텔 곳 직접 빵 굽다 만들다 또 다양 음식 있다 아침 바다 보다 먹다 여유 해보다 부탁|호텔에서 직접 구워 만든 빵을 포함한 다양한 메뉴들과 함께 바다가 보이는 창가에 앉아 여유로운 아침을 맞이해보세요.
금진 온천 피곤 쌓이다 풀리다 돕다 휴식 시간|금진 온천 그동안의 피로를 한번에 녹여줄 휴식 시간
온천수 천연 영양 합 많다 피부 물 묻다 또 피부 진정 돕다 있다|천연 미네랄 다량 함유 온천수는 피부 보습과 진정 효과를 가지고 있는 특별한 온천수입니다.
금진 온천 곳 보통 생활 때 몸 피곤 마음 힘들다 풀다 해보다 부탁|일상 속 지친 몸과 마음을 완화 시켜주는 명품 사우나 금진 온천에서 그동안 쌓였던 피로를 시원하게 날려 보세요.
경포호 거울 똑같다 맑다 호수|경포호 거울 같이 맑은 호수
걷다 때 자연 모습 또 만들다 꾸미다 물건 보다 심심 없다|걷는 동안 심심할 틈이 없게 하는 자연의 아름다운 모습과 테마에 맞게 잘 꾸며져 있는 조형물들은
즐기다 재미있다 가능|산책의 즐거움과 재미를 더해준답니다.
다양 회 바다 향 있다 깨끗 반찬|모둠 회 정식 바다 향기 가득 담은 신선한 한 끼
바다 방문 꼭 먹다 필요|바다에 왔으면 한 번은 꼭 먹고 가셔야죠!
주문진 수산 시장 곳 새롭다 깨끗 물고기 또 다양 회 반찬 먹다 즐기다 부탁|주문진 수산 시장에서 신선한 해산물, 다양한 반찬과 함께 제공되는 모둠 회 정식을 즐겨보세요!
주문진 수산시장 재래시장 1936년부터 계속|주문진 수산 시장 1936년부터 형성된 재래 시장
재래시장 1936년부터 계속 여기 곳 종합 시장, 건어물 시장. 회 센터 포함 있다|1936년부터 형성된 재래시장으로 종합 시장, 건어물 시장, 회 센터 등을 포함한 다양한 형태의 상가와 연계되어있습니다.
수산 시장 항상 활동 힘 또 새롭다 깨끗 물고기 많다|싱싱한 해산물이 가득하고 언제나 활력이 넘치는 수산 시장이에요.
1일차|1일차
차 돕다 타다 곳 모이다 다음 설명|픽업 장소 집결 및 안내
곳 따르다 시간 다르다|장소에 따라 시간 상이
손님 결정 차 돕다 타다 곳 모이다 때 계획 설명 이후 강릉 출발 (휴게소 1회 경유)|고객님이 선택한 픽업 장소 앞에서 집결하여 일정 안내 후 강릉 출발 (휴게소 1회 경유)
월정사|월정사
1시간 30분 아마|1시간 30분 소요 예정
숲 길 걷다 또 사찰 구경|숲길 산책 및 사찰 구경
점심 식사|점심식사
1시간 아마|1시간 소요 예정
산채 백반 (먹다 변경 가능 아마)|산채백반 (메뉴는 변경될 수 있습니다)
발왕산 케이블카|발왕산 케이블카
2시간 소요 예정|2시간 소요 예정
용평 발왕산 관광 케이블카 길이 왕복 7.4km 국내 가장 길다 곳|왕복 7.4km 국내 최대 길이의 용평 발왕산 관광 케이블카
숙소 곳 출발 (호텔 탑스텐)|숙소로 이동 (호텔 탑스텐)
숙소 곳 출발 이후 휴식|숙소로 이동 후 휴식
숙소 방 승인 확인 이후 저녁 식사|숙소 체크인 후 저녁식사
오후 4시 30분 아마|오후 4시 30분 예정
호텔 탑스텐 곳 방 승인 확인 이후 저녁 식사 및 휴식|호텔 탑스텐에 체크인 후 저녁식사 및 휴식
2일차|2일차
아침 식사 이후 모이다|아침식사 후 집결
오전 7:00 아마|오전 7:00 예정
호텔 조식 식사|호텔 조식 식사
금진 온천|금진온천
3시간 아마|3시간 소요 예정
온천수 천연 영양 합 많다 곳|천연 미네랄 다량 함유 온천
경포호|경포호
30분 아마|30분 소요 예정
호수 거울 똑같다 맑다|거울 같이 맑은 호수
점심 식사|점심식사
1시간 아마|1시간 소요 예정
다양 회 정식 (먹다 변경 가능 아마)|모둠회 정식 (메뉴는 변경될 수 있습니다)
주문진 수산 시장|주문진 수산시장
1시간 소요 예정|1시간 소요 예정
재래시장 1936년부터 계속|1936년부터 형성된 재래시장
집 돌아가다|귀가
오후 6시 30분 아마|오후 6시 30분 예정
여행 끝 이후 차 돕다 내리다 곳 출발 이후 해산|투어가 종료 된 후 차를 타고 드랍오프 장소로 이동 및 해산
<포함사항>|<포함사항>
숙박 3 성급 호텔/리조트|숙박 3 성급 호텔/리조트
교통/기사 승합차|교통/기사 승합차
식사 호텔 조식 (부분 일정), 호텔 조식 및 여행 지역 곳 방식 먹다 (부분 일정)|식사 호텔 조식 (부분일정), 호텔 조식 및 현지식 (부분일정)
티켓 입장권 전체 포함, 체험비 전체 포함|티켓 입장권 전체 포함, 체험비 전체 포함
인도 사람  운전 인도 사람 (전체 일정)|가이드 드라이빙 가이드 동행 (전체일정)
기타 돕다 차 돕다 타다, 여행 사람 보내다 돕다(?), 여행 사람 보험|기타서비스 픽업, 센딩, 여행자보험
카누 크다 타다 춘천 구경|킹카누를 타고 느껴보는 춘천의 자연
춘천 이름 한자 봄 물 흐르다 의미 있다 춘천 곳 사계절 계속 봄 모든 사람들 방문 여행 곳|봄 춘(春), 내 천(川), 사계절이 모두 봄인 춘천은 모든 세대가 찾아오는 만인의 여행지입니다.
항상 똑같다 반복 여행 그만|매번 똑같은 정적이고 비슷한 여행은 그만!
카누 타다 구경 또 다리 밑 투명 구름 걷다 느끼다 비슷 가능|카누를 타고 자연을 즐기며 투명다리에서 구름 위를 걷는 듯한 짜릿함을 느낄 수 있습니다.
봄 해 비치다 따뜻 또 구경 보다 즐기다 많다 맛있다 많다 곳 춘천 여행 가다 해보다|따스한 봄볕과 함께 눈이 즐거워지는 볼거리와 ‘맛’까지 겸배한 춘천으로 떠나요!
(기본 선택)|(기본옵션)
평일/주말 1인당 139,000원|평일/주말 1인당 139,000원
(포함 사항)|(포함사항)
차 돕다 타다 (수도권 기준)|단독 차량 픽업서비스(수도권 기준)
운전 사람 또 인솔 사람|기사 및 인솔자
입장 및 체험비|입장 및 체험비
점심 식사|점심식사
여행 사람 보험|여행자 보험
|(불포함 사항)||(불포함 사항)
기타 개인 경비|기타 개인 경비
(여행 인원)|(여행인원)
최소 출발 인원 4인 (최대 6인)|최소 출발인원 4인 (최대 6인)
춘천 여행 소양강 보다|소양강과 함께하는 춘천여행
소양강 유리 걷다 물 걷다 느끼다 비슷 경험 해보다|소양강 스카이워크 물 위를 걷는 듯한 기분을 느껴보세요
소양강 처녀상 옆 국내 가장 길다 투명 다리 걷다 해보다|소양강 처녀상 옆에 있는 국내 최장 길이의 투명 다리를 걸어봐요!
날씨 좋다 날 하늘 반사 보이다 사진 찍다 구름 서다 있다 비슷 느끼다|날씨가 좋은 날에는 하늘이 반사되어 구름 위에 서있는 듯한 사진을 남기실 수 있습니다.
막국수&편육 춘천 가장 유명하다 음식 막국수|막국수&편육 춘천하면 막국수, 막국수 하면 춘천!
막국수 소스 맛있다 또 진짜 메밀 만들다 먹다 해보다|맛있는 양념과 순메밀로 만든 감칠맛이 일품인 막국수를 즐겨봐요!
편육 부드럽다 함께 먹다 맛있다 감동 2배|부드러운 편육과 함께 먹으면 맛도 감동도 2배!
물길 곳 카누 크다|물길로 킹카누 국내에서 가장 유명한 물길 여행
지역 붕어 섬 물 풀 숲 곳 카누 타다 가다 구경|붕어섬 꼬리 물 풀 숲 지역을 카누를 타고 이동하며 둘러봐요.
식물 물 자라다 보다 또 태양 빛 발전 관련하다 설명 듣다 가능|수생 식물을 관찰하고 태양광 발전에 대한 설명을 들을 수 있어요.
의암호 북한강 흐르다 잠시 얌전 있다 때 카누 타다|북한강이 흐르다가 잠시 동안 머무르는 의암호의 고요한 수면 위를 킹카누를 타고 즐기며
호수 멋있다 구경 즐기다|호수 안의 멋드러진 풍경을 구경해봐요.
김유정 문학 마을 글 쓰다 사람 이름 김유정 책 구경|김유정 문학촌 김유정 작가의 작품감상
문학 마을 곳 한국 대표 짧다 책 쓰다 사람 이름 김유정 그 생각 또 책 기념 위하다 설립|한국의 대표적인 단편문학 작가 김유정의 사상과 문학을 기리기 위해 설립된 문학촌입니다.
김유정 살다 또 책 쓰다 구경 걷다 해보다 부탁|김유정의 삶과 작품 세계를 관람하며 가벼운 산책을 즐겨보세요!
1일차|1일차
차 돕다 타다 곳 모이다 다음 설명|픽업 장소 집결 및 안내
곳 따르다 시간 다르다|장소에 따라 시간 상이
차 돕다 타다 곳 모이다 때 하루 계획 설명 이후 춘천 출발 (휴게소 1회 경유)|픽업 장소에서 집결 및 일정 안내 후 춘천으로 이동 (휴게소 1회 경유)
소양강 유리 걷다|소양강 스카이 워크
1시간 아마|1시간 소요 예정
유리 걷다 걷다|스카이 워크 산책
점심 식사|점심 식사
1시간 아마|1시간 소요 예정
막국수 또 편육 (먹다 변경 가능 아마)|막국수와 편육 (메뉴는 변경될 수 있습니다)
물길 걷다 카누 크다|물길로 킹카누
2시간 아마|2시간 소요 예정
카누 타다 의양댐 삼악산 여행 곳 구경|카누를 타고 의암댐 삼악산 코스 구경
김유정 문학 마을|김유정 문학촌
1시간 아마|1시간 소요 예정
김유정 태어나다 살다 집 기념 전시 구경 곳 김유정 이야기 집 관람|김유정 생가, 기념전시관, 김유정 이야기집 관람
집 돌아가다|귀가
오후 5시 아마|오후 5시 예정
여행 끝 집 출발 이후 해산|투어가 종료 된 후, 집으로 이동 및 해산
<포함사항>|<포함사항>
교통/기사 승합차|교통/기사 승합차
식사 호텔 조식 (부분 일정), 호텔 조식 및 여행 지역 곳 방식 먹다 (부분 일정)|식사 호텔 조식 (부분 일정), 호텔 조식 및 현지식 (부분 일정)
티켓 입장권 전체 포함, 체험비 전체 포함|티켓 입장권 전체 포함, 체험비 전체 포함
인도 사람  운전 인도 사람 (전체 일정)|가이드 드라이빙 가이드 동행 (전체 일정)
기타 돕다 차 돕다 타다, 여행 사람 보내다 돕다(?), 여행 사람 보험|기타 서비스 픽업, 센딩, 여행자 보험
1박 2일 동안 자연 친밀|자연을 벗삼아 1박2일 즐기기!
춘천 힐링 여행|춘천 힐링여행
늙다 사람 맞추다 여행|어르신 맞춤여행
춘천 자연 구경 여행|자연에서 즐기는 춘천 힐링 여행!
산 강 아름답다 춘천 곳 카누 타다 또 남이섬 곳 드라마 이름 겨울연가|산과 강이 어우러진 호반의 도시 춘천에서 이색적인 카누 체험과 겨울연가
촬영 곳 유명하다 구경 여행 즐기다 해보다 부탁|촬영지로도 유명한 남이섬 구경으로 여행의 설렘을 느껴보세요.
춘천 대표 유명하다 음식 먹다 여행 즐기다 가능|춘천을 대표하는 음식들을 즐기며 미식 여행 역시 즐기실 수 있습니다.
기본 선택|기본옵션
가격 평일/주말 1인당 408,000원|가격 평일/주말 1인당 408,000원
포함 사항|포함사항
차 돕다 타다 (수도권 기준)|단독 차량 픽업 서비스(수도권 기준)
운전 사람 또 인솔 사람|기사 및 인솔자
입장 및 체험비|입장 및 체험비
모든 계획 식사 또 숙소 포함|전 일정 식사 및 숙소
여행 사람 보험|여행자보험
불포함 사항|불포함 사항
기타 개인 경비|기타 개인 경비
여행 인원 최소 출발 인원 4인 (최대 6인)|여행 인원 최소 출발 인원 4인 (최대 6인)
계획 요약|일정 요약
1일차|1일차
소양강 유리 걷다|소양강 스카이 워크
물길로 카누 크다|물길로 킹카누
김유정 문학 마을|김유정 문학촌
2일차|2일차
남이섬|남이섬
이야기 버스 여행|스토리 버스 투어
유니세프 나눔 열차|유니세프 나눔 열차
※ 지역 상황 따르다 계획 변경 가능|※ 상기 일정은 현지 사정에 따라 변동 될 수 있습니다.
춘천 닭갈비|춘천 닭갈비
춘천 곳 대표 음식|춘천의 대표 향토 음식
닭갈비 춘천 대표 유명 음식 먹다 더 먹다 원 매우 많다|감칠맛 나고 푸짐한 음식으로 유명한 닭갈비는 춘천의 대표 메뉴입니다.
다양 닭갈비 나 원 맞추다 선택 먹다 해보다|다양한 맛의 닭갈비를 기호에 맞게 선택해서 드셔보세요!
2일차|2일차
남이섬|남이섬
남이섬 이름 바꾸다 나미나라 나라 섬 안 작다 나라|섬 안의 작은 나라, 나미나라 공화국
남이섬 이름 두 개 나미나라 공화국 부르다 여기 곳 세계 전부 구경 여행 사람 아름답다|나미나라 공화국이라고도 불리는 남이섬은 전 세계 관광객들에게 아름다운
동화 또 노래 선물 주다|동화와 노래를 선물하는 이 세상에 유일무이한 상상 공화국입니다.
남이섬 사계절 항상 아름답다 모습 다르다 모든 사람 구경 여행 곳|각 계절마다 다른 아름다움을 보여주는 남이섬은 만인의 여행지랍니다.
이야기 버스 여행|스토리버스 투어
남이섬 곳곳 이야기 비밀 찾다 해보다|남이섬 곳곳에 숨어있는 이야기들을 찾아보자
남이섬 외곽 한 바퀴 돌다 때 이야기 비밀 듣다|남이섬 외곽을 한바퀴 돌며 곳곳에 숨겨진 아기자기한 이야기들을 들어봐요!
남이섬 모습 새롭다 보다 즐기다 가능|남이섬의 새로운 모습들을 알아가는 재미가 쏠쏠합니다.
남문 정식|남문정식
고급 한국 방식 음식 식당|한국식의 고풍스러운 한식당
실내 안 한국 전통 방식 꾸미다 또 불고기 맛있다 남자 여자 노인 아이 모두 좋다|전통적인 인테리어와 맛이 어우러진 곳에서 남녀노소 모두가 좋아하는 불고기를 준비했어요.
음식 깨끗 준비 눈 보다 먹다 즐기다|가지런한 한 상 차림은 눈과 입을 즐겁게 합니다.
유니세프 나눔 열차|유니세프 나눔 열차
남이섬 곳 기차 마음 안전|남이섬에서 느끼는 힐링 그 자체의 기차 감성
선착장 부터 섬 중앙까지 배 타다 가다 깨끗 숲 아름답다 강 또 남이섬 매력 느끼다 가능|선착장부터 섬의 중앙까지 이동하며 청정한 숲과 아름다운 강, 그리고 매혹적인 남이섬을 느껴볼 수 있는 열차입니다.
남이섬 곳 늦다 여유 시원 바람 구경|시원한 바람을 맞으며 찬찬히 남이섬을 둘러봐요!
※ 지역 상황 따르다 계획 변경 가능|※ 상기 일정은 현지 사정에 따라 변동 될 수 있습니다.
1일차|1일차
차 돕다 타다 곳 모이다 다음 설명|픽업 장소 집결 및 안내
오전 8시 예정|오전 8시 예정
차 돕다 타다 곳 만나다 이후 계획 설명 다음 춘천 출발 (휴게소 1회 경유)|픽업 장소에서 집결 및 일정 안내 후 춘천으로 이동 (휴게소 1회 경유)
소양강 유리 걷다|소양강 스카이 워크
1시간 아마|1시간 소요 예정
유리 걷다 걷다|스카이워크 산책
점심 식사|점심식사
1시간 아마|1시간 소요 예정
막국수 또 편육 (먹다 변경 가능 아마)|막국수와 편육 (메뉴는 변경될 수 있습니다.)
물길 걷다 카누 크다|물길로 킹카누
2시간 아마|2시간 소요 예정
카누 타다 의양댐 삼악산 여행 곳 구경|카누를 타고 의암댐 삼악산 코스 구경
김유정 문학 마을|김유정 문학촌
1시간 아마|1시간 소요 예정
김유정 태어나다 살다 집 기념 전시 구경 곳 김유정 이야기 집 관람|김유정 생가, 기념전시관, 김유정 이야기집 관람
저녁 식사|저녁식사
1시간 아마|1시간 소요 예정
닭갈비 (먹다 변경 가능 아마)|닭갈비 (메뉴는 변경될 수 있습니다.)
숙소 곳 출발|숙소로 이동
더잭슨나인스호텔 또 등급 (2인 1실 기준)|더잭슨나인스호텔 혹은 동급 (2인 1실 기준)
2일차|2일차
아침 식사|아침식사
오전 9시 아마|오전 9시 예정
호텔 조식|호텔 조식
남이섬|남이섬
4시간 아마|4시간 소요 예정
이야기 버스 여행, 유니세프 나눔 열차, 점심 식사(남문), 자유 시간|스토리버스투어, 유니세 프나눔 열차 탑승, 점심 식사(남문), 자유 시간
집 돌아가다|귀가
오후 2시 아마|오후 2시 예정
여행 끝 집 출발 이후 해산|투어가 종료 된 후, 집으로 이동
2박 3일 두근두근|울릉대는 가슴 안고, 2박 3일
울릉 곳 바다 낚시|울릉에서 즐기는 바다 낚시 여행
최소 4인 ~ 최대 6인|최소 4인 ~ 최대 6인
여행 가격|여행가격
평일/주말 698,000원/1인|평일/주말 698,000원/1인
불포함사항|불포함사항
강릉여객터미널 가다 교통비|강릉여객터미널로 오는 교통비
울릉도 평생 한 번 방문 필요|인생에 한 번은 가봐야할 울릉도 여행
점심 울릉도 바다 물고기 가득|울릉도 해산물이 가득한 깔끔한 중식
해물 백짬뽕|해물 백짬뽕
울릉도 곳 비밀 맛있다 식당 곳 시간 오래 배 타다 몸 피곤 힘들다 또 어지럽다 백짬뽕 먹다 잊다 가능|울릉도 숨겨진 맛집에서 백짬뽕을 즐겨봐요. 장시간 배를 타고 와 피곤한 몸과 어지러운 멀미를 잊게 해 주는 시원한 맛입니다.
독도 자랑 우리 땅|자랑스러운 우리의 땅, 독도
독도 케이블카&독도 박물관|독도 케이블카&독도박물관
케이블카 타다 도동향 보다 가능 곳 까지|도동항이 한눈에 보이는 멋진 뷰를 볼 수 있는 전망대까지 케이블카를 타고 가 볼 수 있습니다.
날씨 좋다 날 독도 보다 가능|날씨가 좋은 날엔 독도도 볼 수 있다고 합니다.
케이블카 타 내리다 한국 처음 땅 박물관 곳 독도 박물관 방문 우리 모르다 땅 배우다 가능|케이블카를 타고 내려와 대한민국 유일의 영토 박물관인 독도 박물관을 둘러보며 몰랐던 아름다운 우리 땅을 알아봐요.
봉래 폭포 사계절 계속 아름답다 곳|사계절 내내 아름다운 폭포 봉래폭포
놀이 30m 폭포 3단 물 충분 많다 1년 계속 보다 가능 울릉도 살다 사람 물 마시다 가능 돕다 곳|높이 30m의 3단 폭포로 수량이 풍부해 1년 낸내 볼 수 있고 울릉도민의 소중한 식수원입니다.
여름 덥다 때 계속 물 차갑다 유지 때문 자연 에어컨 같다 시원 바람 곳 쉬다 가능|폭포를 보러 걷다 쉼이 필요할 때 쯤 한여름에도 서늘한 냉기가 나와 천연 에어컨이라 불리는 풍혈에서 쉬어가요.
에메랄드 빛 바다 보다 걷다|에메랄드 빛 바다와 동행하듯 산책
행남 해안 걷다 곳|행남 해안 산책로
행남 해안 산책 길 신 직접 만들다 이야기 정도 멋있다 유명하다 곳|신이 빚은 작품이라 불리는 국가 지질 공원의 지질 명소 중 하나인 행남 해안 산책로!
울륭도 경사 많다 하지만 여기 곳 걷다 편하다 가능|경사가 많은 울릉도에서 편안히 산책을 즐길 수 있는 코스입니다.
구수 부드럽다 최고|구수하고 연한 식감이 일품
약소 들깨 전골|약소 들깨 전골
소 울릉도 곳 자라는 약초 뜯다 먹다 자라다 또 들깨향 넣다 전골 만들다 울릉도 곳만 먹다 가능|울릉도에서 나는 약초를 먹여 키운 소와 고소한 들깨향으로 만든 전골은 울릉도에서만 맛볼 수 있는 현지의 맛입니다.
울릉도 여행 첫번째 날 마지막 따뜻하다 국물 먹다 쉬다|뜨끈한 국물과 함께 약소 들깨 전골로 울릉도 첫째 날을 마무리합니다.
2일차, 직접 바다 낚시|2일차, 바다 낚시로 제대로 느껴보는 손 맛
우리 나라 10대 멋있다 곳 보다 가능 기회|우리나라의 10대 비경을 만날 수 있는 기회
태하향목 모노레일|태하향목 모노레일
모노레일 타다 오르다 기암 향나무 소나무 보다 구경 가능|모노레일을 타고 올라가면서 기암과 향나무, 소나무를 보며 자연을 감상할 수 있습니다.
산 오르다 힘들다 대신 모노레일 타다 편하다 울릉도 멋있다 구경 가능|오르기 힘든 경사를 모노레일을 타고 편안히 올라가 울릉도 최고의 비경을 만나보세요.
아름답다 북 바다 시작 곳|아름다운 북면 해안이 본격적으로 시작되는 곳
현포항|현포항
현포 구경 보다 곳 다르다 나라 방문 구경 느끼다 비슷|현포 전망대에서 바라보는 전경은 이국적인 느낌을 주며 마치 해외에 온 듯한 기분을 느끼게 해 줍니다.
노인봉 또 현포 마을 모두 보다 가능|노인봉과 현포 마을 전경까지 한 눈에 담을 수 있습니다.
울릉도 유일 평평하다 곳|울릉도의 유일한 평야
나리분지|나리분지
예전 선조 살다 투막집 너와집 보다 우리 역사 직접 구경 가능|옛날 선조들의 삶의 터전이던 나리분지는 투막집과 너와집 등 우리 역사의 한 부분을 직접 만나볼 수 있습니다.
길 평평하다 때문 늦다 여유 걷다 가능|평지인만큼 산책하듯 천천히 둘러보기 좋습니다.
울릉도 곳만 먹다 가능|울릉도만의 맛과 정성을 느낄 수 있는 한 상
산채 비빔밥|산채 비빔밥
울릉도 곳 먹다 베풀다 넘치다 느끼다 가능|울릉도의 푸짐한 인심을 느낄 수 있는 한 상.
산채 비빔밥 몸 건강 돕다 또 엉겅퀴, 울릉도 부추, 부지깽이, 명이 나물 낯설다 하지만 반찬 보다 침 흘리다|건강하게 한 끼를 먹을 수 있는 산채 비빔밥과 엉겅퀴, 울릉도 부추, 부지깽이, 명이 나물 등 생소하지만 군침 도는 밑반찬까지!
울릉도 곳 점심 먹다 최고|울릉도에서 즐길 수 있는 최고의 점심 식사입니다.
직접 물 반 고기 반 느끼다|물반 고기반을 직접 느껴봐요.
천부항|천부항
천부항 예전 울릉도 오징어 잡다 배 중심 곳|한때 울릉도 오징어 잡이 배들의 중심 어항이었던 천부항
송곳봉이 솟다 또 옆 공암 있다 보다 구경 좋다|돌아보면 송곳봉이 우뚝 솟아있고 옆으론 공암이 있어 시선을 멈추게 합니다.
천부항 물고기 많다 모두 낚시 가능|천부항에서 물고기가 많아 누구나 쉽게 낚시를 즐기실 수 있습니다.
꽁치 물회 가장 새롭다 깨끗 때 먹다|가장 신선한 상태의 꽁치를 즐길 수 있는 꽁치물회
꽁치 물회 만들다 때 부드럽다 꽁치 또 쓰다 소스 또 야채 넣다 먹다 맛있다|부드러운 꽁치와 새콤한 소스, 그리고 야채가 만들어내는 하모니가 일품인 꽁치물회입니다.
육지 곳 물회 먹다 다르다 새롭다 깨끗하다 먹다 가능|육지에서 먹는 물회와는 비교할 수 없는 신선함을 느껴보실 수 있습니다.
3일차 깨끗 맛있다 먹다|3일차 청정미식
울릉도 여행 마지막 날|울릉도 여행 마지막날
도착 오후 5:00 강릉 여객 터미널|도착 오후 5:00 강릉여객터미널
울릉도 곳 유람선 타다 구경 편하다 가능|편안하게 유람선으로 둘러보는 울릉도
해상 구경 여행 유람선|해상관광 유람선
2시간 동안 공암, 관음도, 쌍용굴 곳 배 타다 보다 땅 곳 보다|2시간 동안 공암, 관음도, 쌍용굴 등 울릉도 대표 관광명소를 육지에서와는 다른 뷰로 즐길 수 있는 해상 유람선 바다 위에서 보면,
다르다 느끼다 경험 가능|같은 장소도 전혀 다른 느낌을 주는 것을 경험할 수 있어요.
따개비 칼국수 겉 딱딱 속 부드럽다 먹다 맛있다|꼬들꼬들하고 감칠맛으로 가득한 따개비 칼국수
따개비 칼국수 울릉도 곳 특별 맛있다 음식|울릉도에서 별미로 즐겨 먹는 따개비 칼국수
쫄깃하다 또 국물 맛 진하다 먹다 바다 느끼다 가능|쫄깃하고 고소한 식감을 가지고 있고 진한 국물은 짙은 바다의 맛을 담고 있습니다.
강릉 여객 터미널 모이다|강릉 여객 터미널 집결
오전 7시 30분 아마|오전 7시 30분 예정
안내 사항 전달 및 페리 승선|안내 사항 전달 및 페리 승선
점심식사|점심식사
1시간 아마|1시간 소요 예정
해물 백짬뽕 (먹다 변경 가능 아마)|해물 백짬뽕 (메뉴는 변경될 수 있음)
독도 케이블카 & 독도 박물관|독도 케이블카 & 독도 박물관
1시간 30분 소요 예정|1시간 30분 소요 예정
독도 역사 설명 또 케이블카 타다|독도에 대한 역사 설명 및 케이블카 탑승
봉래폭포|봉래폭포
1시간 아마|1시간 소요 예정
봉래 폭포 구경 여행 또 기념 사진|봉래 폭포 관광 및 기념 촬영
행남해안산책로|행남해안산책로
1시간 아마|1시간 소요 예정
바다 길 걷다 울릉도 구경|해안산책로를 걸으며 울릉도 바다보기
저녁 식사|저녁식사
1시간 아마|1시간 소요 예정
약소 들깨 전골 (먹다 변경 가능 아마)|약소 들깨전골 (메뉴는 변경될 수 있음)
숙소 곳 출발|숙소로 이동
다온 프라임 호텔 아니면 동급 리조트 (2인 1실 기준)|다온프라임호텔 혹은 동급 리조트 (2인 1실 기준)
2일차|2일차
아침 식사|아침식사
오전 8시 아마|오전 8시 예정
호텔 조식 또는 여행 지역 곳 방식 먹다|호텔 조식 또는 현지식
태하향목모노레일|태하향목모노레일
1시간 30분 아마|1시간 30분 소요 예정
모노레일 타다 이후 태하 전망대 구경 여향|모노레일 탑승 후 태하전망대 관광
현포항|현포항
30분 아마|30분 소요 예정
현포항 구경 기념 사진|현포항 둘러보며 기념촬영
나리분지|나리분지
30분 아마|30분 소요 예정
나리분지 또 움집 울릉도 곳 유일하다 평평 곳 구결|울릉도의 유일한 평지, 나리분지와 움집 둘러보기
점심 식사|점심식사
1시간 아마|1시간 소요 예정
산채 비빔밥 (먹다 변경 가능 아마)|산채비빔밥 (메뉴는 변경될 수 있음)
천부항|천부항
2시간 아마|2시간 소요 예정
바다 낚시 또 천부해중 전망대 구경|바다낚시와 천부해중전망대 관람
저녁 식사|저녁식사
1시간 아마|1시간 소요 예정
꽁치 물회 (먹다 변경 가능 아마)|꽁치물회 (메뉴는 변경될 수 있음)
숙소 곳 출발|숙소로 이동
다온프라임 호텔 아니면 동급 리조트 (2인 1실 기준)|다온프라임호텔 혹은 동급 리조트 (2인 1실 기준)
3일차|3일차
아침 식사|아침식사
오전 8시 아마|오전 8시 예정
호텔 조식 또는 여행 지역 곳 방식 먹다|호텔 조식 또는 현지식
바다 구경 여향 유람선|해상관광 유람선
2시간 아마|2시간 소요 예정
도동항 곳 유람선 타다|도동항에서 유람선 탑승
점심 식사|점심식사
1시간 아마|1시간 소요 예정
따개비 칼국수 (먹다 변경 가능 아마)|따개비칼국수 (메뉴는 변경될 수 있음)
선착장 곳 출발|선착장으로 이동
강릉 도착 목적 페리 타다|강릉으로 향하는 페리 탑승강원도 지역 구경 여행 좋다 곳|강원도 가볼만한 여행 코스
평창 대관령 지역 양 떼 목장|평창 대관령 양떼목장
강원도 지역 양 떼 목장 가운데 평창 대관령 지역 양떼 목장 곳 가장 아름답다 유명하다 곳|평창 대관령 양떼목장은 강원도에 있는 양떼목장 중 풍경이 가장 아름답기로 유명한 곳입니다
파랗다 하늘 또 풀 눈 보다 좋다 스트레스 풀어지다 가능|푸른 하늘과 초지가 어우러져 스트레스가 해소가 되는 힐링 목장입니다
여행 사진 좋다|사진 여행하기 좋은 곳입니다
또한 풀 넓다 곳 모습 그림 똑같다 풀 뜯다 먹다 양 있다 구경 좋다|또한 그림 같은 초원에서 풀 뜯는 양들이 있어 풍경을 감상하기에 좋은 곳입니다
직접 먹다 주다 체험 가능 우리 안 양 떼 가깝다 보다 가능|먹이주기 체험이 가능합니다 우리 안에 있는 양들을 직접 만날 수 있습니다
강릉 경포대 지역|강릉 경포대
경포대 곳 구경 아름답다|경포대는 아름다운 풍경을 가지고 있습니다
경포대 곳 주변 소나무 또 벚꽃 단풍 다양 있다|경포대 주변에는 소나무와 벚꽃, 단풍 등이 있습니다
주변 여행 좋다 곳 경포 바다 곳 허균허난설헌 태어나다 자라다 곳 또 아르떼 박물관 곳 있다|주변 여행지로는 경포해변, 허균허난설헌 생가터, 아르떼 뮤지엄 등이 있습니다
강릉 경포호 지역 걷다 길|강릉 경포호 둘레길
경포호 지역 걷다 길 곳 경포대 곳 출발 걷다 호수 옆 걷다 길 있다|경포호 둘레길은 경포대에서 내려오면 산책을 즐길 수 있는 호수길입니다
경포호 깨끗하다 물 소나무 숲 또 조각 작품 있다 구경 아름답다|경포호는 맑은 물과 소나무 숲, 조각 작품들이 어우러진 풍경이 아름답습니다
강릉 오죽헌 곳|강릉 오죽헌
오죽헌 곳 신사임당 여자 또 아들 율곡 이이 태어나다 자라다 곳|오죽헌은 신사임당과 율곡 이이가 태어나고 자란 곳입니다
오죽헌 조선 중간 때 짓다 강릉 죽헌당 곳 있다|오죽헌은 강릉 죽헌당에 있는 조선 중기 건물입니다
우리 나라 집 건물 중 가장 오래 건물|우리나라 주택 건물 중 가장 오래된 건물 중 하나입니다
검다 대나무 바람 흔들리다 소리 좋다|검은 대나무가 바람에 흔들리는 소리가 듣기 좋습니다
또 집 앞 흙 평지 곳 해 비추다 따뜻하다 구경 여행 좋다 곳|또한 마당 가득 들어앉은 햇살을 느낄 수 있는 관광지 입니다
강릉 강문 바다 곳|강릉 강문해변
강릉 강문 바다 곳 다르다 여행 곳 보다 사진 곳 많다|강릉 강문해변은 다른 곳보다 포토존이 많습니다 
많다 사람 방문 구경 여행 추억|추억을 만들기 위한 젊은이들이 많이 방문하는 곳입니다
강문 바다 곳 파도 소리 좋다 여행 즐기다 가능|파도 소리가 가득한 강문해변에는 여행의 즐거움이 가득한 곳입니다
다양 카페 곳 회 먹다 곳 있다 모든 사람 좋다 여행 곳|카페, 횟집 등이 다양하게 있어 누구나 좋아하는 강릉의 해변입니다
강문 바다 곳 경포 바다 다르다 작다 조용 얌전하다 곳|또 강문해변은 경포해변과 달리 아담하고 조용한 곳입니다
혼자 여행 사람 구경 좋다|혼자 여행하는 사람에게도 좋은 곳입니다
영월 선암마을 한반도 모양 땅 곳|영월 선암마을 한반도 지형
한반도 모양 땅 영월 구경 여행 좋다 곳 10개 중 8번째 곳|한반도 지형은 영월 10경 중 8경입니다
서강 지역 대표 구경 좋다 곳|서강 지역을 대표하는 경관 중 하나입니다
한반도 모양 땅 구경 곳 보다 정말 한반도 모양 똑같다|한반도 지형 전망대에서 내려다보면 정말 우리나라 지도 같이 생겼습니다
사계절 계속 구경 여행 사람 많다 방문|사계절 내내 관광객들이 찾고 있는 곳입니다
속초 바다 수영 놀다 곳|속초 해수욕장
속초 바다 수영 놀다 곳 속초 대표 구경 여행 곳|속초 해수욕장은 속초를 대표하는 관광지입니다
깨끗 물 또 편리하다 시설 곳 있다|깨끗한 수질과 편의시설이 잘 갖추어져 있습니다
바다 개장 즉시 사람 많다 몰리다 놀다 곳|해수욕장 개장과 동시에 많은 사람들이 방문하는 곳입니다
또 여기 곳 공원 꽃길 또 소나무 숲 곳 걷다 길 곳 있다|이 곳에는 공원과 꽃길 그리고 소나무 숲 사이로 난 산책로가 있습니다
속초 설악 케이블카|속초 설악 케이븥카
설악산 속초 여행 곳 꼭 방문 필요하다 곳|속초 여행 코스로 빼놓을 수 없는 곳이 설악산입니다
직접 산 걷다 오르다 가능|직접 산행이 가능합니다
설악 케이블카 타다 권금성 곳 도착|설악 케이븥카를 타고 권금성까지 오를 수 있습니다
케이블카 타다 오르다 시간 10분 내리다 걷다 시간 5분 정도 이후 권금성 도착|10분 동안 케이블카를 탄 다음 5분 정도 걸으면 권금성에 도착할 수 있습니다
산 정상 바위 여기 서다 설악 구경 보다 가능|바위로 된 정상에서 설악의 풍경을 감상할 수 있습니다
멀다 속초 도시 곳 또 동해 바다 구경 멋있다|멀리 속초 시내가 보이고 동해 바다도 조망할 수 있는 곳입니다
속초 대포 항구 곳|속초 대포항
강원도 속초 곳 구경 여행 좋다 곳 무엇? 속포 대포 항구 곳|강원도 속초 가볼만한곳은 속초 대포항입니다
대포 항구 곳 강원도 바다 보다 가능|대포항에서는 강원도에서 흔히 볼 수 있는 바다가 있습니다
또 줄 오징어 걸리다 바다 바람 해 비추다 모습 보다 가능|또한 해풍에 말리는 오징어를 볼 수 있습니다
새롭다 깨끗하다 물고기 회 썰다 먹다 때문 사람 많다 방문|신선한 횟감을 먹기 위해 많은 관광객들이 방문하고 있습니다
대포 항구 곳 다리 있다 사진 좋다|대포항에는 다리가 있습니다 사진 찍기에 좋은 장소입니다
동해 바다 또 설악 산 구경 보다 좋다|동해 바다와 설악산의 풍경이 아주 아름답습니다
고성 화진포 바다 수영 놀다 곳 또 화진포 성 곳|고성 화진포 해수욕장&화진포의 성
고성 화진포 곳 화진포 바다 수영놀다 곳 또 화진포 성 있다|고성 화진포에서는 화진포 해수욕장과 화진포의 성이 있습니다
동쪽 바다 가운데 가장 조용 얌전 곳|동해에서 가장 조용한 해변입니다
물 깊다 없다 소나무 숲 넓다 있다|수심이 얕고 울창한 송림이 있습니다
구경 보다 멋있다 곳|자연 풍경이 아름다운 곳입니다
화진포 성 곳 이름 바꾸다 부르다 무엇 북한 김일성 남자 쉬다 놀다 집 곳|화진포의 성은 김일성 별장이라고 불리기도 합니다
여기 곳 눈 내리다 보다 구경 멋있다|내려다보는 풍경이 일품인 곳에 자리 잡고 있습니다
고성 이승만 쉬다 놀다 집 곳|고성 이승만 별장
고성 화진포 바다 수영 놀다 곳 거리 1km 곳 이승만 쉬다 놀다 집 있다|고성 이승만 별장은 화진포 해수욕장과 1km도 안되는 거리에 있습니다
이승만 쉬다 놀다 집 곳 화진포 기념 구경 보다 있다|이승만 별장에는 화진포 기념관이 있습니다
여기 곳 이승만 남자 대통령 때 활동 무엇 또 평생 살다 무엇 보다 가능|이 곳에서 이승만 대통령의 업적과 일대기를 볼 수 있습니다
고성 송지호 바다 곳 송지호 구경 건물 곳|고성 송지호 바다&송지호 전망타워
송지호 넒다 약 20만 평 정도 또 물 깊다 5m 정도 물 소금 포함 때문 겨울 때 물 얼다 없다|송지호는 약 20만 평이고, 수심이 5m에 달하며 짠물이 섞여 겨울에도 잘 얼지 않습니다
송지호 구경 건물 곳 5층 또 건물 모습 독특|송지호 전망타워는 5층으로 독특한 건물로 되어 있습니다
송지호 곳 철새 날다 보다 가능|송지호에서 떼 지어 다니는 철새들을 볼 수 있습니다
회 썰다 먹다 또 선물 사다 좋다|회를 먹으러 가거나 선물을 사기 좋은 곳입니다
새롭다 깨끗 문어 꽃게 전복 조개 외 다양 물건 사다 가능|싱싱한 문어, 꽃게, 전복 등 다양한 상품을 살 수 있습니다 
인제 원대리 자작나무숲 곳|인제 원대리 자작나무숲
인제 자작나무숲 곳 무엇 강원도 인제 곳|인제 자작나무숲은 강원도 인제에 위치해 있습니다
자작나무 춥다 지역 곳 자라다|자작나무는 추운 지방에서 자라는 나무입니다
우리나라 숲 관리 청 인제 곳 가장 처음 자작나무 숲 만들다|우리나라 산림청에서 인제에 처음으로 자작나무로 숲을 조성했습니다 
자작나무숲 곳 사계절 모습 달라 사계절 모두 방문 좋다|자작나무숲은 사계절 풍경이 달라져 계절마다 방문하기 좋습니다
삼척 쏠비치 산토리니 광장 곳|삼척쏠비치 산토리니 광장
강원도 삼척 산토리니 곳 그리스 나라 산토리니 비슷 곳 있다|강원도 삼척에는 그리스에 있는 산토리니를 연상케하는 곳이 있습니다
산토리니 곳 건물 파랗다 색 하얗다 색 칠하다 옆 바다 있다 마을 곳|산토리니는 블루와 화이트만으로 되어 있는 바다가 보이는 마을입니다
삼척 곳 건물 파랗다 색 하얗다 색만 짓다|삼척에도 블루와 화이트 컨셉으로 건물을 지었습니다
산토리니 넓다 곳 걷다 또 사진 가능|산토리니 광장에서 산책을 하거나 사진을 찍을 수 있습니다
홍천 알파카 공원|홍천 알파카랜드
강원도 홍천 알파카 공원 곳 서울 차 운전 1시간 도착 가능|서울에서 자동차로 1시간 반 정도 걸리는 곳은 강원도 홍천 알파카랜드입니다 
알파카 외 다른 동물 보다 가능|알파카 외에도 다른 동물들을 만날 수 있습니다
알파카 놀다 곳 울타리 들어가다 가능|알파카 놀이터에서는 울타리 안으로 들어갈 수 있습니다 
알파카 직접 만지다 또 먹다 주다 가능|알파카를 만지고 자유롭게 먹이를 줄 수 있습니다
또 알파카 함께 걷다 가능|또 알파카와 함께 산책하는 코스도 있습니다
철원 고석정 꽃밭 진도길|철원 고석정 꽃밭 잔도길
강원도 철원 곳 서울 차 운전 1시간 30분 도착 가능|강원도 철원은 서울에서 자동차로 1시간 30분이면 도착합니다
철원 지역 북쪽 곳 때문 여름 때 시원|북쪽에 자리 잡고 있어 여름에도 시원합니다
축구장 33개 넓다 정도 구역 꽃 다양 심다 보다 가능|축구장 33개 넓이로 구역별로 꽃을 종류별로 심었습니다
곳곳 연못 또 철원 두루미 모양|곳곳에 연못도 여러 곳 있고 철원 두루미 조형물도 있습니다
포토존도 있어 사진 찍기에 좋은 곳입니다
경기도 지역 구경 여행 좋다 곳|경기도 가볼만한 여행 코스
포천 산정 호수|포천 산정호수
산정 호수 곳 서울 곳 거리 72km 정도|산정호수는 서울에서 72km 정도 떨어진 거리에 있습니다
교통 간편하다 또 산 구경 멋있다|교통이 편리하고 산 경치가 멋있습니다
주말 때 산 걷다 오르다 사람 또 걷다 구경 사람 많다 방문|주말이면 산행하는 사람들과 산책하러 오는 사람들이 많습니다
호수 곳 오리 배 타다 가능|호수에서 오리배를 타는 사람들이 있습니다
나무 또 풀 멋있다|나무와 풀들이 아름답습니다
사진 찍다 곳 있다 사진 좋다|포토존이 설치되어 있어 사진 찍기에도 좋습니다
가족 구경 놀다 또 데이트 좋다 곳 때문 사람 많다 방문|가족 나들이나 데이트 하기에 좋은 곳으로 국민 관광지라 불립니다
과천 서울대공원|과천 서울대공원
과천 서울대공원 곳 경기도 여행 좋다 곳 추천|과천 서울대공원은 경기도 여행지로 추천하는 곳입니다
우리 나라 동물원 가운데 가장 넓다 또 식물원 서울랜드 있다|우리 나라에서 가장 큰 동물원과 식물원 그리고 서울랜드가 있습니다 
가족 함께 구경 놀다 시간 즐기다|가족과 함께 즐거운 시간을 보낼 수 있습니다
봄 때 벚꽃 길 있다 구경 아름답다 좋다|봄에는 벚꽃길이 있어 걸어서 구경하기 좋습니다
하지만 걷다 불편 또 힘들다 대신 코끼리 열차 타다 구경 가능|하지만 걷기 불편하면 코끼리 열차를 타고 관광할 수 있습니다
이천 산수유 마을|이천 산수유 마을
이천 산수유 마을 곳 서울 출발 1시간 도착 가능|이천 산수유 마을은 서울에서 1시간 정도면 갈 수 있는 곳입니다
마을 길 걷다 가장 안쪽 나무 산수유 피다 많다 곳 있다|마을길을 따라 걷다보면 마을 가장 안쪽에 산수유가 피어 있는 군락지가 있습니다
이천 산수유 마을 안 조선시대 때 한옥 정자 곳 이름 육괴정 있다|이천 산수유 마을에는 한옥 건물로 된 조선시대 정자인 육괴정이 있습니다
걷다 좋다 돌담길 곳 있다|산책하듯 걷기 좋은 돌담길도 있습니다
수원 화성 방화수류정|수원 화성 방화수류정
방화수류정 곳 조선 나라 후기 때 왕 정조 건축 1794년 건축 시작 1796년 10월 건축 완료|방화수류정은 조선 후기 정조 때인 1794년에 착공하여 1796년 10월에 준공되었습니다
구경 아름답다 즐기다 가능|아름다운 자연 환경을 즐길 수 있습니다
주변 행궁 곳 구경 놀다 많아|주변에 행궁부터 다양한 볼거리가 있습니다
용인 대장금 공원|용인 대장금파크
대장금 공원 곳 용인 구봉산 곳 있다|용인시 구봉산에 자리 잡고 있는 대장금 파크입니다
약 84만 평 정도 우리나라 가장 넓다 촬영 곳 사람 구경 가능|우리나라 최대 규모인 총 84만 평 부지에 조성된 오픈 세트장입니다
용인 대장금 공원 곳 과거 고구려 백제 신라 나라 때 고려 나라 때 조선 나라 때 집 생활 모습 건축|용인 대장금 파크는 삼국시대, 고려시대, 조선시대의 건축양식과 생활공간을 지었습니다
수도 곳 가까워 구경 걷다 좋다|수도권과 멀지 않아 나들이 하기에 좋은 곳입니다
용인 한국 사람 모이다 살다 곳|용인 한국민속촌
용인 한국 사람 모이다 살다 곳 1974년 개장 한국 전통 문화 또 사람 살다 모습 그대로 만들다|용인민속촌은 1974년에 개장하여 한국의 전통 문화와 민속적인 삶을 재현한 곳입니다
조상 지혜 또 생활 모습 보다 가능|조상들의 지혜와 생활 모습을 느낄 수 있습니다
전통 기와 집 초가 집 외 조선 나라 때 건물 그대로 닮다 또 보존|전통 기와집과 초가집을 비롯해 조선시대 때 건물들을 재현, 보존하고 있습니다
넓다 약 30만 평 정도 깨꿋 꾸미다 사진 좋다|면적이 30만 평입니다 깨끗하게 잘 가꾸어 놓아 사진 찍기에 좋습니다
광주 곤지암 화담숲|광주 곤지암 화담숲
곤지암 화담숲 곳 경기도 광주 곳 구경 여행 좋다|곤지암 화담숲은 경기도 광주에서 가볼만한곳입니다
다양 꽃 또 숲 모습 깨끗 걷다 좋다|다양한 꽃들과 잘 정돈된 숲이 있어 산책하기 좋습니다
숲 걷다 길 곳 걷다 편안 좋다|숲 산책 코스에서는 데크길이 잘 조성되어 있어 걷기 좋습니다
폭포 멋있다 구경 많다|폭포도 잘 조성되어 있어 볼거리도 많습니다
가평 쁘띠프랑스|가평 쁘띠프랑스
가평 쁘띠프랑스 곳 국내 곳 프랑스 방문 느끼다 비슷|가평 쁘띠프랑스는 국내에서 프랑스를 만날 수 있는 곳입니다
국내 프랑스 모습 꾸미다 곳 가평 쁘띠프랑스 곳 처음|국내에서 프랑스를 배경으로 꾸며놓은 곳은 가평 쁘띠프랑스가 유일합니다
다양 구경 곳 또 사진 찍다 곳 많아 데이트 좋다|다양한 볼거리와 포토존이 많아 데이트 코스로 좋은 곳입니다
프랑스 나라 작다 마을 방문 여행 느끼다 비슷 가능|마치 프랑스의 작은 마을을 여행 온듯한 기분을 느낄 수 있습니다
프랑스 문화 또 생활 경험 가능 곳 또 구경 곳 박물관 있다|프랑스의 문화, 생활을 엿볼 수 있는 체험과 전시관, 박물관이 있습니다
가평 에델바이스 스위스 마을|가평 에델바이스 스위스 마을 
가평 스위스 마을 곳 경기도 곳 운전 좋다 또 사진 좋다 곳|가평 스위스 마을은 경기도 드라이브 코스입니다 사진 찍기 좋은 곳입니다
스위스 나라 작다 마을 그대로 닮다|스위스의 작은 마을을 그대로 옮겨 놓은 듯합니다
아름답다 숲 또 마을 보다 멋있다|아름다운 숲과 마을이 잘 어울어져 있습니다
처음 방문 곳 걷다 양 보다 가능 또 양 먹다 주다 체험 가능|입구를 지나면 양들을 볼 수 있고 또 양 먹이 체험도 할 수 있습니다
가평 스위스 마을 중간 곳 쉬다 곳 또 카페 있다|가평 스위스 마을 중간 쯤에는 쉴 수 있는 공간과 카페도 있습니다
양평 두물머리|양평 두물머리
두물머리 곳 남한강 북한강 합 곳|두물머리는 남한강과 북한강이 만나는 곳입니다
여기 곳 일출 유명 곳 때문 사진 목적 사람 방문 많다|이 곳은 일출 명소로 사진을 찍기 위해 오는 사람들이 있습니다
팔당호 곳 옆 차 운정 서울 가깝다 곳 운전 좋다|팔당호를 끼고 달리는 코스는 서울근교 드라이브 코스로 최적의 장소입니다
먹다 곳 있다 또 카페 많다 때문 하루 여행 가다 오다 좋다|식당도 있고 카페도 많아 당일치기 여행으로 가기 좋습니다
가평 아침고요수목원|가평 아침고요수목원
아침고요소목원 곳 경기 가평 있다 넓다 약 10만 평 정도|아침고요수목원은 경기도 가평에 위치하여 10만 평의 면적을 차지하고 있습니다
서울 차 운전 1시간 정도 하루 구경 여행 좋다|서울에서 차로 1시간 정도 걸려 당일치기로 다녀오기 좋은 관광지 입니다
겨울 때 오색 별빛 정원 있다 때문 화려 빛 축제 구경 여행 가능|겨울에는 오색별빛정원전이 펼쳐지고 있어 화려한 빛 축제를 관람할 수 있습니다
넓다 정원 곳 LED 전구 꾸미다 빛 멋있다 아름답다|넓은 정원에 LED 전구를 사용하여 인공적인 조명으로 아름다움을 느낄 수 있습니다 
안산 탄도 항|안산 탄도항
안산 탄도 항 곳 안산 선감동 곳 항구|안산 탄도항은 안산 선감동에 있는 어항입니다
바다 또 바다 바람 시원 때문 시간 여유 즐기다 가능|탁 트인 바다와 시원한 바닷 바람을 즐기며 여유로운 시간을 보낼 수 있습니다
다르다 나라 구경 느끼다 비슷 사람 많다 방문|이국적인 풍경을 즐길 수도 있어 많은 사람들이 찾는 곳입니다
저녁 때 해 지다 빛 멋있다 사진 기술 사람 방문 있다|낙조가 아름다워 사진가들도 많이 찾습니다
경상도 지역 구경 여행 좋다 곳|경상도 가볼만한 여행 코스
통영 동피랑 벽화 마을|통영 동피랑 벽화마을
통영 동피랑 벽화 마을 통영 구경 여행 좋다 곳|통영 동피랑 벽화마을은 통영에서 가볼만한 곳입니다
통영 여행 때 꼭 방문 구경 데이트 좋다|통영 여행 시 빼놓을 수 없는 데이트 코스입니다
골목길 벽 그림 모습 보다 가능|골목길에 그려진 벽화를 볼 수 있습니다
또 카페 곳 앉다 바다 보다 멋있다 좋다|또 전망 좋은 카페에 않다 바다를 볼 수 있습니다
동피랑 정상 곳 동포루 있다 여기 곳 구경 좋다|동피랑 정상에는 동포루가 있습니다 풍경이 아름답습니다
통영 서피랑 공원|통영 서피랑 공원
서피랑 공원 곳 동피랑 벽화마을 차 5분 거리 정도|서피랑 공원은 동피랑 벽화마을과 차로 5분 정도 떨어진 곳입니다
복잡 없다 여유 걷다 통영 도시 구경 가능|복잡하지도 않고 한가롭게 산책하면서 통영 시내를 볼 수 있습니다
서피랑 공원 곳 우체통 빨간색 또 옆 구경 보다 곳 있다|서피랑 공원은 빨간 우체통과 그 옆에 있는 전망대가 있습니다
또 계단 99개 있다|그리고 99개 계단이 있습니다
책 쓰다 사람 박경리 태어나다 자라다 곳 보다 가능|소설가 박경리의 생가터를 둘러볼 수 있습니다 
통영 바다 밑 터널|통영 해저터널
통영 바다 밑 터널 곳 일본 한국 공격 때 짓다|통영 해저터널은 일제감정기 때 건설된 터널입니다
당동 곳 부터 마수동 곳 까지|당동에서 시작해서 마수동까지 이어져 있습니다
차 다니다 안되다 사람 또 자전거 다니다 가능|차량 통행은 금지되고 자전거와 사람만 통행이 가능합니다
바다 밑 터널 아시아 가장 처음 짓다 지금 문화재 등록|동양 최초의 해저터널로 지금은 등록문화재로 지정된 곳입니다
역사 의미 있다 여름 때 걷다 시원 가능|역사적인 의미가 있는 곳입니다 여름에는 시원해서 걷기 좋습니다
경주 동궁원|경주 동궁원
경주 동궁원 곳 식물 보호 온도 따뜻 곳 겉 유리|경주 동궁원은 유리온실로 된 실내 식물원입니다
겨울 때 식물 있다 걷다 구경 마음 스트레스 줄이다 구경 여행 곳|한겨울에도 식물들이 있어 산책하는 동안 힐링이 되는 관광지입니다
경주 황리단길|경주 황리단길
경구 황리단길 곳 경주 가장 유명 곳|경주 황리단길은 경주에서 가장 핫한 곳입니다
겉 한옥 모습 그대로 안 지금 방식 새로 고치다 꾸미다|한옥의 외형은 남겨둔 채 내부는 현대식으로 인테리어가 되어 있습니다
카페 먹다 곳 사진 곳 기념 물건 간단 먹다 외 다양 구경 또 먹다 있다|카페, 레스토랑, 사진관, 기념품, 간식거리 등 다양한 볼거리와 먹거리가 있습니다
골목 길 걷다 재미있다|또한 골목길을 걷는 재미도 쏠쏠한 곳입니다
예쁘다 한옥 카페 많다 또 사진 찍다 좋다|예쁜 한옥 카페가 많이 있고 사진 찍기에도 좋습니다
경주 월정교|경주 월정교
경주 월정교 곳 낮 보다 밤 더 아름답다 월정교 곳 해 지다 빛 있다|경주 월정교는 낮보다 밤이 더 아름다운 곳입니다
월정교 곳 해 지다 빛 있다|월정교는 해가 지고 나면 조명이 들어옵니다
월정교 밤 멋있다 사람 많다 방문|월정교의 야경을 보기 위해 많은 사람들이 찾는 곳입니다
부산 국제 시장|부산 국제시장
부산 대표 구경 여행 곳 관련하다 영화 유명|부산 국제시장은 영화으로도 유명한 부산 대표 관광지입니다
부산 전통 시장 가운데 국제 시장 깡통 시장 둘 유명|국제시장은 깡통시장과 함께 부산에서 유명한 전통 시장입니다
국제 시장 곳 다양 물건 있다 또 넓다|국제시장은 다양한 물건들이 있고 규모도 상당합니다
부산 자갈치 시장|부산 자갈치시장
부산 여행 구경 곳 자갈치 시장 방문 좋다|자갈치시장은 부산 가볼만한 여행 코스입니다
회 먹다 또 선물 사다 좋다|회를 먹으러 가거나 선물을 사기 좋은 곳입니다
새롭다 깨꿋 문어 꽃게 전복 외 다양 물건 사다 가능|싱싱한 문어, 꽃게, 전복 등 다양한 상품을 살 수 있습니다 
부산 송도해상케이블카|부산 송도해상케이블카
부산 송도 해상 케이블카 곳 동쪽 송림공원 부터 서쪽 암남공원 까지 거리 1.62km 정도|부산 송도해상케이블카는 동쪽 송림공원에서 서쪽 암남공원까지 1.62km 정도의 코스입니다
바닥 눈 보다 유리 때문 땀 나다 즐기다 가능|바닥이 투명 유리로 되어 있어 스릴을 즐길 수 있습니다
구경 시원 또 송도 곳 파랗다 바다 보다 가능|시원한 풍경과 아름다운 송도의 푸른 바다를 볼 수 있습니다
부산 감천 문화 마을|부산 감천문화마을
부산 감천 문화 마을 곳 부산 구경 여행 때 꼭 방문 필요 곳|부산 감천문화마을은 부산 여행에서 빼놓을 수 없는 여행 코스입니다
국내 여행 사람 외 다르다 나라 여행 사람 방문 구경 여행 많다|국내 여행자 뿐만 아니라 해외 여행자들도 많이 찾는 곳입니다
어린 왕자 또 여우 있다 곳 사진 찍다 유명|어린 왕자와 여우는 인기 있는 포토 스팟입니다
감천 문화 마을 곳 카페 많다|감천문화마을은 카페들도 많이 있습니다
구경 보다 좋다 카페 곳 커피 마시다 가능|전망 좋은 카페에서 커피 한잔하기에 좋습니다
거제 매미성|거제 매미성
거제 매미성 섬 북쪽 곳 있다|거제 매미성은 섬 북쪽에 위치한 곳에 있습니다
거제도 여행 때 꼭 방문 필요 구경 여행 곳|거제도 여행 코스에서 빼놓을 수 없는 관광지입니다
매미성 곳 사람 혼자 쌓다|매미성은 개인이 혼자 16년 동안 쌓았습니다 
마을 입구 건너편 곳 카페 있다|마을 입구 길 건너편에는 카페가 있습니다 
지금 구경 여행 좋다 사람 많다 방문 곳|지금은 가볼만한 관광지가 되어 많은 사람들이 방문하는 곳입니다
거제 바람 언덕|거제 바람의 언덕
바람 언덕 곳 도장포 마을 언덕 곳 구경 여행 좋다|바람의 언덕은 도장포 마을에 있는 언덕이자 관광지입니다
바다 가깝다 바람 분다 많다 때문 이름 바람 언덕 부르다|바다와 가까이 있어 바람이 많이 불어 바람의 언덕이라고 불리고 있습니다
바람 언덕 곳 네덜란드 풍차 있다|바람의 언덕에는 네덜란드 풍차가 있습니다
여기 곳 방문 사진 꼭|이 곳에 오면 반드시 사진 찍어야 할 곳입니다
거제 카페 마소마레|거제 카페 마소마레
마소마레 카페 곳 3층|마소마레는 3층으로 되어 있는 카페입니다
야외 곳 바다 보다 가능|바다가 바로 보이는 야외 테라스가 있습니다
카페 곳 음료 커피 더 간단 먹다 빵 있다|카페는 음료와 커피뿐만 아니라 간식으로 먹을 수 있는 베이커리가 있습니다 
바다 보다 즐기다 가능|바다를 바라보며 즐길 수 있는 곳입니다
문경새재도립공원|문경새재도립공원
문경새재 곳 경상북도 도립공원 결정|문경새재는 현재 경상북도 도립공원으로 지정되어 있습니다
문경 구경 좋다 곳 무엇 문경새재 사람 구경 가능 촬영 곳 국내 가장 넓다|문경 가볼만한곳인 문경새재 오픈 세트장은 국내 최대의 규모의 사극 촬영장이 있습니다
과거 고려 나라 모습 지금 조선 나라 모습 바꾸다|과거에는 고려시대 배경이었으나 현재는 조선시대 배경입니다 
한복 입다 사진 좋다|한복 입고 사진 찍기에 좋은 장소입니다
문경 오미자 터널|문경 오미자테마터널
오미자 터널 곳 요즘 문경 구경 좋다 유명 곳|요즘 문경 가볼한만곳으로 핫한 장소는 오미자테마터널입니다
터널 안 사진 붙이다 구경 좋다 때문 사람 많다 방문|터널 안에 사진이 장식되어 있어 많은 사람들이 찾는 명소입니다
문경 오미자 터널 길이 540m|문경오미자테마터널의 길이는 총 540m입니다
길이 200m 정도 문경 지역 자라다 오미자 이용 꾸미다|200m 구간은 문경의 특산물인 오미자로 테마를 꾸몄습니다
또 오미자 이용 만들다 와인 음료 마시다 가능 곳 있다|또 오미자로 만든 와인과 음료를 마실 수 있는 공간도 있습니다
사진 가능 곳 많다 좋다|곳곳에 포토존이 마련되어 있어 사진 찍기 좋습니다
하동 북촌 코스모스 메밀 축제|하동 북천 코스모스 메밀 축제
북천 코스모스 메밀 축제 곳 무엇 경남 하동 이명 마을 곳|북천 코스모스 메밀 축제는 경남 하동 이명마을에서 열립니다  
9월 마지막 10월 초 때 춪게 열리다 사람 많다 방문 곳|축제는 9월 말에서 10월 초에 열립니다 많은 사람들이 방문하는 축제입니디
메밀 꽃 모습 눈 내리다 비슷 또 코스모스 꽃 아름답다|하얗게 눈이 내린 듯 핀 메밀꽃과 코스모스 꽃이 아릅답습니다
꽃 사진 좋다|꽃을 배경으로 사진을 찍기에 좋은 곳입니다
전라도 지역 구경 여행 좋다 곳|전라도 가볼만한 곳
여수 오동도|여수 오동도
오동도 곳 여수 방문 때 꼭 여행 필요|오동도는 여수 여행에서 빼놓을 수 없는 여행지입니다
걷다 구경 또 동백 열차 타다 오동도 도착 구경 가능|도보로 걷거나 동백 열차를 타고 오동도까지 이동 가능합니다
여수 오동도 곳 독특 식물 수 193종 있다 숲 넓다 매우|여수 오동도에는 193종의 희귀 수목이 울창한 숲을 이루고 있습니다
예전 오동 나무 많다 때문 오동도 부르다|예전에는 오동나무가 많아 오동도라고 불렀습니다
지금 오동나무 줄이다 대신 동백 나무 늘어나다 이름 바꾸다 동백섬 부르다|지금은 오동나무보다 동백나무가 많아 동백섬이라고 부르기도 합니다
여수 항일암|여수 향일암
향일암 곳 여수 구경 여행 좋다 곳 가운데 하나|향일암은 여수 가볼만한곳 중 하나입니다
일출 보다 위하다 방문 사람 많다|일출을 보기 위해 찾는 사람이 많습니다
돌산도 곳 보다 구경 많다 또 구경 멋있다 카페 많다|향일암이 있는 돌산도에는 볼거리가 많고 뷰가 아름다운 카페도 많습니다
여수 예술 공원|여수 예술랜드
여수 예술 공원 곳 남쪽 바다 보다 가능 구경 멋있다|여수 예술랜드는 남해를 조망할 수 있고 뷰가 특히 아름다운 곳입니다
남쪽 바다 가깝다 곳 조각 작품 구경 가능|남해 바다를 볼 수 있는 곳에서 조각 작품을 관람할 수 있습니다
경험 놀다 가능 곳 또 사진 곳 있다 사진 가능|또한 체험할 수 있는 곳과 사진을 찍기 좋은 포토존이 있습니다
여수 바다 케이블카|여수 해상케이블카
여수 여행 때 여수 바다 케이블카 타다 경험 꼭 필요|여수 해상케이블카는 여수 여행에서 꼭 체험해봐야 하는 것 중 하나입니다
바다 위 케이블카 타다 돌산 공원 부터 자산 공원 도착 왕복 가능|돌산공원부터 자산공원까지 바다 위로 왕복이 가능합니다
우리나라 가장 처음 바다 케이블카 여수 곳 아름답다 구경 가능|여수의 아름다운 풍경을 내려다볼 수 있는 케이블카는 우리나라 최초의 해상케이블카입니다
여수 이순신 광장|여수 이순신 광장
여수 곳 이순신 장군 관련하다 많다|여수는 이순신 장군과 많은 관련이 있습니다
이순신 장군 관련하다 물건 구경 곳 있다|이순신 장군에 관련된 것이 전시되어 있습니다 
거북선 보다 가능|거북선도 전시되어 있습니다
광장 곳 주변 먹다 맛있다 곳 많아 때문 여행 사람 방문 많다|광장은 꽤 넓은 편으로 주변에 맛집이 많아 많은 관광객들이 즐겨 찾는 곳입니다
순천 낙안읍성|순천 낙안읍성
순천 낙안읍성 곳 예전 모습 그대로 유지 전통 마을|순천 낙안읍성은 옛 모습을 그대로 간직하고 있는 전통마을입니다
조선시대 때 모습 순천 낙안읍성 곳 무엇? 전라남도 순천 낙안 곳|순천 낙안읍성은 전라남도 순천시 낙안면에 있는 조선시대의 읍성입니다
순천 여행 때 꼭 방문 필요 곳|순천 여행 시 꼭 들러야 하는 명소입니다
전통 한옥 있다 또 실제 살다 사람 있다|전통 한옥들이 있으며 현재 실제 주민들이 거주 중입니다
지금 대한민국 세계 유산 임시 등록 있다|현재 대한민국 세계유산 잠정 목록에 등재되어 있습니다
순천만 국가 정원|순천만국가정원
순천만 국가 정원 우리나라 처음 국제 정원 구경 곳 개설 구경 끝 이후 다시 꾸미다 정원 곳|순천만국가정원은 우리나라에서 처음 개최한 국제정원박람회가 폐막한 이후 개조하여 조성한 정원입니다
전라남도 곳 구경 여행 아름답다 좋다 추천|아름다운 곳으로 전라남도 가볼만한곳으로 추천하는 관광지 입니다
이름 국가 정원 맞추다 구경 보다 많다|국가 정원이라는 타이틀에 걸맞게 볼거리가 많습니다
순천만 국가 정원 넓다 매우 때문 시간 여유 구경 좋다|순천만국가정원은 굉장히 넓기 때문에 충분한 시간을 가지고 둘러보는 것이 좋습니다
순천 물 많다 넓다 땅|순천만습지
순천 물 많다 넓다 땅 곳 순천만 국가 정원 남쪽 곳 있다|순천만습지는 순천만국가정원 남쪽에 자리 잡고 있습니다
갈대밭 곳 약 15만 평 정도|갈대밭이 무려 약 15만 평이 달하는 곳입니다
갈대밭 중간 걷다 길 있다 걷다 기분 좋다|갈대밭 사이로 조성해 놓은 데크길을 산책하면 절로 힐링되는 곳입니다
갈대밭 곳 쉬다 곳 또 새 보다 가능 곳 있다|갈대밭 중간중간에 쉽터와 철새를 관찰할 수 있는 곳이 있습니다
고창 파랗다 보리 밭|고창 청보리밭
고창 파랗다 보리 밭 곳 사진 기술 사람 외 구경 여행 사람 많다|고창 청보리밭은 사진 작가는 물론 많은 관광객이 찾는 곳입니다
보리 메밀 심다 자라다 예쁘다 때 있다|보리와 메밀이 가장 아름답게 피어나는 시기가 있습니다
때 파랗다 보리 밭 축제 또 메밀 밭 축제 있다|그때는 청보리밭 축제, 메밀밭 축제가 있습니다
다양 축제 있다|다양한 축제와 이벤트가 개최하고 있습니다
보리 메밀 이용 만들다 요리 먹다 곳 있다|보리와 메밀을 원재료로 하는 다양한 음식을 판매하는 식당이 있습니다
또 차 음료 간단 먹다 팔다 사다 곳 있다|또한 차, 음료, 간식을 판매하는 매점이 있습니다
자다 곳 또 다양 시설 있다|숙박시설 등 다양한 부대시설이 있습니다
목포 바다 케이블카|목포 해상 케이블카
목포 바다 케이블카 곳 우리나라 가장 길다 케이블카 거리 3.23km|목포 해상 케이블카는 우리나라에서 최장 거리인 3.23km 입니다
목포 도시 북항 곳 출발|목포 시내 북항 스테이션을 출발합니다
유달산 정상 지나가다|유달산 정상부를 거칩니다
바다 위 케이블카 고하도 도착|바다 위를 지나 고하도까지 연결되어 있습니다
전주 한옥 마을|전주 한옥마을
전주 곳 구경 또 먹다 곳 많다|전주 한옥마을에는 볼거리는 물론 먹거리가 많습니다
체험 곳 많다 때문 구경 여행 한국 문화 경험 가능|체험할 수 있는 곳이 많이 있어 가장 한국적인 관광지라고 할 수 있습니다
골목 길 곳 카페 많다 때문 하루 계속 좋다|골목길에 카페가 많이 있어 하루종일 있기 좋습니다
또 전통 한옥 체험 가능|또한 전통 한옥을 체험할 수 있습니다
담양 메타프로방스|담양 메타프로방스
담양 메타프로방스 곳 프랑스 나라 남부 지역 곳 작다 마을 비슷 짓다|담양 메타프로방스는 프랑스 남부 지역의 작은 마을을 모티브로 한 곳입니다
건물 모습 유럽 방문 구경 느끼다 비슷|마치 유럽에 온듯한 건물들이 들어서 있어 이국적인 풍경을 즐길 수 있습니다
상가 곳 다양 체험 또 구경 곳 먹다 곳 많다|상가 내에는 다양한 체험과 볼거리 그리고 먹거리가 가득합니다
마을 곳 물건 싸다 팔다 곳 자다 곳 또 편하다 시설 있다|또한 아울렛, 펜션 등 각종 편의 시설을 갖추고 있는 마을입니다
해남 공룡 박물관|해남 공룡박물관
해남 공룡 박물관 곳 해남 지역 유명하다 구경 여행 곳|해남 공룡박물관은 해남의 명소로 알려져 있습니다
세계 유명 공룡 모습 가짜 만들다|세계적으로 유명한 공룡 모형이 전시되어 있습니다
공룡 박물관 곳 안 야외 다양 공룡 가짜 만들다 구경 가능|공룡박물관에서는 실내와 야외에 전시되어 있는 다양한 공룡 조형물을 볼 수 있습니다 
나이 상관 없다 구경 즐기다 가능 많다|나이 상관없이 즐길 수 있는 것들이 많습니다
해남 땅끝마을|해남 땅끝마을
땅끝마을 곳 우리 나라 한반도 가장 남쪽 땅 시작 곳|우리나라 한반도의 최남단 땅끝마을입니다
전라도 해남 곳 여행 때 땅끝마을 곳 꼭 방문 필요|전라도 해남을 가게 되면 반드시 가봐야 할 곳이 땅끝마을이 아닌가 싶습니다
갈두산 정상 곳 땅끝 구경 보다 가능 곳 있다|갈두산 정상에는 땅끝 전망대가 있습니다
남쪽 바다 멋있다 아름답다 구경 가능|남해의 해안절경과 바다의 아름다움을 감상할 수 있습니다
땅끝 구경 보다 곳 방문 한반도 처음 땅 곳 흙 있다|땅끝 전망대에 올라가면 한반도의 시작이라는 뜻으로 첫땅의 흙이 있습니다
부안 변산 바다 수영 놀다 곳|부안 변산해수욕장
전라북도 부안 구경 여행 좋다 곳 무엇 변산 바다 수영 놀다 곳|전라북도 부안 가볼만한 곳으로 추천하는 장소는 변산해수욕장입니다
멋진 하얗다 모래 또 다양 보다 있다 구경 좋다|멋진 백사장과 다양한 볼거리가 있어 관광하기 좋습니다
변산 바다 수영 놀다 곳 옆 송포항 있다 잠깐 걷다 솔밭 멋있다 곳 있다|변산해수욕장 옆에 자리한 송포항에서 조금만 걸으면 멋진 솔밭이 나옵니다
또 바다 구경 보다 곳 3층 건물 있다 때문 변산 바다 또 하얗다 모래 보다 가능|또한 3층 높이의 해변 전망대가 있어 변산 해변과 백사장을 한눈에 볼 수 있습니다
7월 때 바다 수영 놀다 즐기다 구경 사람 방문 많다|7월이 되면 해수욕을 즐기려고 오는 사람들이 많은 인기많은 곳입니다
부안 소나무 섬|부안 솔섬
변산 바다 수영 놀다 곳 방문 전라북도 학생 수련 곳 있다|변산해수욕장으로 올라가면 전라북도 학생수련원이 나읍니다 
여기 곳 앞 바다 곳 작다 소나무 섬 있따|이 곳 앞바다에는 작은 솔섬이 있습니다
서쪽 일물 보다 유명 곳 사진 기술 사람 방문 많아 부안 여행 때 꼭 방문 필요|서해 일몰 명소로 사진가들이 많이 찾는 곳으로 부안 여행에서 빼놓을 수 없습니다
제주 지역 구경 여행 좋다 곳|제주 가볼만한 제주도 여행 코스
성산일출봉|성산일출봉
성산일출봉 곳 제주 대표 여행 곳 또 가장 제주 어울리다 곳|성산일출봉은 제주도의 대표적인 여행 코스입니다 가장 제주스러운 곳입니다
산 걷다 오르다 구경 아름답다 좋다|올라가면서 내려다 보는 풍경도 아름답습니다 
중간 곳 기암괴석 보다 가능|하지만 중간에 있는 기암괴석도 큰 볼거리 입니다
산 길이 180m 정도 정상 도착 시간 약 20분 정도|정상까지는 해발 180m로 20분 정도 걸립니다
정산 도착 보다 분화구 있다|정산에 올라서면 성산일출봉의 움푹 파인 분화구가 나옵니다
또 바위 수 99개 있다 모습 성 같다 이름 부르다 성산|또 99개의 바위 봉우리가 성처럼 보인다고 해서 성산이라고 불렀다고 합니다
올라가다 길 내려가다 길 다르다 또 내려가다 길 쉽다 우뭇가 바다 구경 길 걷다|올라가는 길과 내려가는 길이 다릅니다 내려올 때는 쉽게 내려와서 우뭇가해안 탐방로를 따라
성산일출봉 보다 멋있다 곳 까지 가다 가능|성산일출봉이 가장 아름답게 보이는 곳까지 갈 수 있습니다
섭지코지|섭지코지
섭지코지 곳 제주 동쪽 지역 여행 좋다 곳|섭지코지는 대표적인 제주 동쪽 관광지입니다 
성산일출봉 또 광치기 해안 둘 다 보다 가능|성산일출봉과 광치기 해변을 함께 둘러보기 좋은 장소입니다
섭지코지 해안 걷다 곳 길다 있다 해안 독특 멋있다 구경 또 바다 보다 가능|섭지코지는 해안을 따라 긴 산책로가 이어져 독특한 해안 절경과 바다를 동시에 감상할 수 있습니다
언덕 위 평지 곳 조랑말 타다 체험 가능|언덕 위 평원에서는 조랑말 승마체험을 해볼 수도 있습니다
또 언덕 곳 하얀 등대 있다 그 곳 도착 해안 절벽 또 시골 모습 평화롭다 구경 더해서 성산일출봉 보다 가능|또 언덕에 있는 하얀 등대에서는 해안절벽과 평화로운 시골 풍경, 성산일출봉까지 볼 수 있습니다 
광치기 해변|광치기 해변
성산일출봉 섭지코지 중간 있다 이 곳 일출 보다 좋다 유명하다 곳|성산일출봉과 섭지코지 사이에 있는 해변으로 일출 명소입니다
광치기 해변 걷다 좋다 언제? 밀물 썰물 때 물 절반 이상 내려다가 때|광치기 해변을 걷기 좋은 때는 밀물에서 썰물로 바뀌면서 물이 절반 이상 빠질 때입니다
해변 길 걷다 성산일출봉 모습 가장 멋있다 보다 가능 곳 있다|해변을 따라 걷다보면 성산일출봉을 가장 아름답게 볼 수 있는 곳이 있습니다
광치기 바다 옆 유채밭 있다|광치기 해변 길 건너편에는 유채밭이 있습니다 
유채꽃 피다 때 구경 가능|유채꽃이 피는 계절에는 유채꽃을 볼 수 있습니다
제주민속촌|제주민속촌
제주 민속촌 동쪽 지역 표선 곳 있다 가장 제주 어울리다 곳|동쪽 표선에 위치한 제주민속촌은 제주에서 가장 제주다운 곳입니다.
옛 제주 모습 유지 곳|제주의 옛모습을 간직하고 있는 공간입니다
옆 5분 잠깐 곳 표선 해수욕장 있다 구경 가눙|바로 옆 5분도 안 걸리는 거리에 표선 해수욕장도 있어 바다도 함께 볼 수 있습니다
이 곳 구경 방법 2가지 있다 걷다 구경|이 곳은 걸어 다니며 관광할 수 있습니다 
또 버스 타다 구경 둘 중 선택 가능|또 순환 버스를 타고 원하는 곳에 내려서 관광하는 방법이 있습니다
전통 돌하르방 또 고인돌 있다 제주 옛 모습 직접 눈 보다 체험 가능|전통 돌하르방도 있고 고인돌도 있어 제주의 옛 문화를 직접 눈으로 보며 체험할 수 있습니다
색 다양 꽃 또 전통 가옥 있다 사진 찍다 좋다 유명하다 곳 |형형색색의 꽃들과 전통 가옥이 있어 사진 찍기에도 아주 좋은 장소입니다
함덕 바다 수영 놀다 곳|함덕해수욕장
제주도 동쪽 지역 바다 예쁘다 곳 많다|제주도 동쪽에는 예쁜 해변이 몇 군데 있습니다 
가운데 하나 함덕 바다 수영 놀다 곳|그 중 하나가 함덕해수욕장입니다
제주 함덕 바다 곳 모래 하얗다 또 물 깨끗하다|제주 함덕 해변은 하얀 모래와 맑은 물이 있습니다
서우봉 곳 걷다 함덕 바다 눈 보다 가능|가볍게 산책하기 좋은 서우붕에서 함덕 해변을 한 눈에 볼 수 있습니다
서우봉 걷다 중간 구경 곳 있다|서우봉 중간쯤에는 전망대가 있습니다
또 유채꽃 밭 있다 때문 봄 때 여행 사람 많다 방문 구경 여행 있다|그리고 유채꽃 밭이 있어 봄이면 많은 여행자들이 찾는 곳입니다
초록 색 바다 또 노랗다 유채 꽃 보다 가능 곳|아름다운 에메랄드 빛과 노란 유채가 만나는 풍경을 눈으로 볼 수 있습니다
월정리 바다|월정리 해변
월정리 바다 곳 제주 바다 유명 가운데 하나 물 색 초록색 또 모래 은빛 색|월정리 해변은 에메랄드 빛 바다와 은빛 모래사장이 있는 제주의 유명한 해변입니다
바다 옆 도로 곳 작다 예쁘다 카페 있다|해안도로를 따라 아담하고 예쁜 카페가 있습니다 
카페 곳 커피 마시다 바다 구경 가능|그 곳에서 커피 한 잔 마시며 바다를 즐길 수 있습니다
또 길 곳 의자 작다 있다 앉다 뒤 바다 있다 사진 찍다 멋있다 곳|또 길가에 작은 의자가 있어 바다를 배경으로 사진 찍기에도 좋은 곳입니다
제주 오설록 차 박물관|제주 오설록 티뮤지엄
제주 오설록 차 박물관 곳 국내 처음 차 박물관|제주 오설록 티뮤지엄은 국내 최초의 차 전문 박물관입니다
차 구경 곳 국내 가장 크다 2002년 처음 열리다|국내 최대 규모의 차 종합 전시관으로 2002년 개관했습니다
우리 나라 차 문화 전통 또 역사 배우다 가능 곳|우리나라의 차 문화와 전통, 역사를 만날 수 있는 곳입니다
오설록 곳 만들다 물건 차 구경 곳|오설록에서 만드는 제품과 차에 대한 전시관으로 구성되어 있습니다 
제주 여행 방문 인기 많다 제주 오설록 차 박물관 곳|제주 오설록 티뮤지엄은 드넓은 녹차밭이 있습니다
넓다 크다 녹차밭 또 카페 방문 구경 즐기다 가능|또 카페까지 즐길 수 있는 인기만점 제주 관광지입니다
충청도 지역 구경 여행 좋다 곳|충청도 가볼만한 여행 코스
공주 한옥 마을|공주 한옥마을
공주 한옥 마을 곳 숙소 목적 짓다|공주 한옥마을은 숙박업소로 만든 곳입니다
공주 곳 주말 때 걷다 구경 또 데이트 좋다|주말 나들이나 데이트 하기 좋은 곳인 공주 여행 코스입니다
국립 공주 박물관 또 무령 왕 무덤 곳 중간 있다 함께 구경 좋다|국립공주박물관과 무령왕릉 사이에 있어 함께 둘러보기 좋습니다
마을 뒤 동산 작다 있다 아이 놀다 좋다|마을 뒤에는 자그마한 동산이 있어 아이들이 놓기 좋습니다
또 한옥 마을 눈 보다 구경 가능 곳|또한 한옥 마을이 한 눈에 보여 풍경을 감상하기 좋은 곳입니다
태안 신두리 바다 모래 언덕|태안 신두리 해안사구
태안 신두리 바다 모래 언덕 곳 우리나라 바다 모래 언덕 곳 중 가장 크다|태안 신두리 해안사구는 우리나라 최대 해안사구입니다
2001년 천연 기념 결정 곳 또 한국 구경 여행 좋다 곳|2001년 천연기념물로 지정된 곳으로 한국 관광 100선에 선정되었습니다
모래 언덕 걷다 구경 사막 느끼다 비슷|모래언덕을 지나면 마치 사막 느낌이 나는 곳이 있습니다
다르다 나라 구경 느끼다 비슷 즐기다 가능|이국적인 풍경을 즐길 수 있습니다
태안 천리포 나무 구경 곳|태안 천리포수목원
태안 천리포 나무 구경 곳 우리 나라 나무 구경 곳 중 가장 크다 곳|태안 천리포 수목원은 우리나라에서 최고의 수목원입니다
정원 곳 다양 꽃 어마어마 많다 때문 구경 멋있다|정원에는 수많은 꽃들이 심겨져 있어 아름다운 풍경을 즐길 수 있습니다
1960년 부터 천리포 바다 옆 곳 천리포 나무 구경 곳 짓다 시작|천리포 수목원은 1960년 초부터 천리포 해변에 본격적으로 조성했습니다
보령 해저 터널|보령 해저터널
보령 해저 터널 곳 대천 바다 수영 놀다 곳 가깝다 대천항 출발 원산도 연결|대천해수욕장에서 가까운 대천항에서 출발해 원산도를 연결하는 보령 해저터널입니다 
보령 해저 터널 곳 국내 가장 길다 세계 5번째 길다|해저터널로는 국내에서 가장 길고 세계에서 5번째로 깁니다
터널 마지막 곳 원산도 곳 저두 바다 수영 놀다 곳 있다|터널을 지나오면 원산도에 있는 저두해수욕장을 볼 수 있습니다
보령 꽃지 바다 수영 놀다 곳|보령 꽃지해수욕장
보령 꽃지 바다 수영 놀다 곳 우리 나라 가운데 가장 일몰 유명|보령 꽃지해수욕장은 우리나라 최고의 일몰 명소 중 하나입니다
서해 일몰 유명 곳 때문 사진 기술 사람 방문 많다|서해 일몰 명소이기 때문에 사진가들이 일몰을 찍기 위해 많이 방문합니다
하얗다 모래 넓다 약 5km 정도 또 할머니 바위 할아버지 바위 있다 구경 멋있다|5km에 이르는 백사장과 할미바위와 할아비바위가 있어 멋있는 풍경을 볼 수 있습니다
서해 해 지다 모습 아름답다 때문 우리 나라 구경 여행 좋다 곳 선택 결정|서해 낙조는 아름다운 풍경으로 우리나라 관광지로 선정되었습니다
논산 은빛 자연 편안 쉬다 숲|논산 온빛자연휴양림
논산 은빛 자연 편안 쉬다 숲 곳우리 나라 편안 쉬다 숲 곳 하지만 다르다 나라 여행 느끼다 비슷|논산 은빛 자연 휴양림은 이국적인 풍경이 가득한 우리나라 휴양림입니다
메타세쿼이아 나무 많다 때문 사진 좋다 곳|메타세쿼이아 나무가 가득해 사진 찍기에 좋은 장소입니다
또 메타세쿼이아 나무 잘 어울리다 집 있다 다르다 나라 구경 여행 느끼다 비슷|또한 메타세쿼이아 나무와 잘 어울리는 집들이 있어 다른 나라가 온듯합니다
조용 얌전 걷다 마음 스트레스 줄이다 도움|조용히 산책이 가능해 절로 힐링이 되는 곳입니다 레몬 과 귤 비타민 시 많다|레몬과 귤은 비타민 C가 많다
미희 와 지수 여고 동창|미희와 지수는 여고 동창이다
말하다 보다 그 소설가 시인 또는 아마|말하는 것으로 보아 그는 소설가나 시인일 것이다
바자회 물품 으로 책 또 옷 받다 있다|바자회 물품으로 책이나 옷을 받고 있다
그 사람 염치 그리고 체면없다|그 사람은 염치고 체면이고가 없어
책 그리고 책상 다 타다 끝|책이고 책상이고 다 타 버렸다
청소 그리고 빨래 쉬다 없다 하다 하지만 집안일 끝 없다|청소니 빨래니 쉬지 않고 해도 집안일은 끝이 없다
떡 그리고 과일 배부르다 먹다 끝|떡이니 과일이니 잔뜩 먹었다
그 농구 그리고 축구 못하다 운동 없다|그는 농구다 축구다 못하는 운동이 없다
연습 그리고 레슨 시간 하나 없다|연습이다 레슨이다 시간이 하나도 없다
백화점 가다 구두 모자 그리고 원피스 사다 끝|백화점에 가서 구두랑 모자랑 원피스랑 샀다
떡 그리고 과일 많다 먹다 끝|떡이랑 과일이랑 많이 먹었다
교수 또 정치가 또 내로라하다 저명인사 모두 모이다 끝|교수며 정치가며 내로라하는 저명인사가 모두 모였다
옷 또 신 죄다 흩어지다 있다|옷이며 신이며 죄다 흩어져 있었다
붓 그리고 먹 가져오다|붓하고 먹을 가져오너라
시골 에서 쌀 그리고 무 그리고 배추 보내오다 끝|시골에서 쌀하며 무하며 배추하며 보내왔다
잔칫집 에서 밥 떡 그리고 술 아주 잘 먹다 끝|잔칫집에서 밥에 떡에 술에 아주 잘 먹었다
미역과 다시마는 칼슘이 많다|미역 과 다시마 칼슘 많다
대륙 과 해양 기후 다르다|대륙과 해양은 기후가 다르다
너 와 나 아니다 면 우리 조국 지키다|너와 내가 아니면 우리 조국을 누가 지키랴
건강 위하다 담배 또 술 끊다 꼭|건강을 위해 담배나 술을 끊어야 한다
그 일 학벌 그리고 뭐 다 소용없다|그 일에는 학벌이고 뭐고 다 소용없다
슬픔 그리고 기쁨 다 느끼다 못하다|슬픔이고 기쁨이고 다 느끼지 못한다
시장 사과 그리고 배 온갖 과일 다 있다|시장에는 사과니 배니 온갖 과일이 다 있다
잡채 그리고 불고기 다 차리다 주다 끝|잡채다 불고기다 있는 것은 다 차려 주었다
나 영희 철수 그리고 영수 나 집 초대하다 끝|나는 영희랑 철수랑 영수를 우리 집에 초대했다
잔칫상 배 또 대추 또 사과 여러가지 과일 차리다 있다|잔칫상에는 배며 대추며 사과며 여러 가지 과일이 차려져 있었다
그림 또 조각 또 미술품 으로 차다 화실|그림이며 조각이며 미술품으로 가득 찬 화실
어머니 그리고 언니 다 직장 다니다|어머니하고 언니하고 다 직장에 다닌다
아버지 책 연필 그리고 장난감 여러가지 많이 사다 받다 끝|아버지가 책에 연필에 장난감에 이것저것 많이 사 주셨다
주인 많다 드세요 권하다|주인이 많이 드세요라고 권한다
나 사장님 만세 말하다|내가 사장님 만세라 했던가
가게 휴가 중 메모 붙다 있다|가게에는 ‘휴가 중이라고 메모가 붙어 있었다
문 곳 입춘대길 쓰다 있다 끝|문에는 ‘입춘대길이라 쓰여 있었다
아내 나에게 묻다 낙엽 밟다 소리 좋다|아내는 나더러 낙엽 밟는 소리가 좋으냐고 물었다
서울 눈 많다 내리다 아마|서울에는 눈이 많이 내렸다나 어쨌다나
요리사 많다 드세요 권하다|요리사가 많이 드세요 라고 권한다
조카 나에게 묻다 삼촌 비가 내리다 소리 좋다|조카가 나에게 삼촌은 비 내리는 소리가 좋으세요 라고 물었다
그 먹보 떡 도 좋다 나에게 말하다 때 알다 되다|그 먹보가 떡도 좋지라 할 때는 알아보았어야지
팻말 금지구역 쓰다 있다 끝|팻말에는 ‘금지구역이라고 쓰여 있었다
아직 도 너 잘하다 생각하다|아직도 네가 잘했다고 생각하느냐?
나에게 자기 대신가다 아마|나더러 자기 대신 가라나 어쩌라나
아무리 바쁘다 도 식사 것 하다 꼭 되다|아무리 바쁘더라도 식사는 해야지
아무리 하다 도 흥분 가라앉다 아직|아무리 해도 흥분이 가라앉질 않았다
너 어째서 혼자 시장에 가다|너는 어쩌자고 혼자 시장에를 갔니
영어 것 지문자 철수 도사|영어야 철수가 도사지
너 도 잘못 있다|너에게도 잘못은 있다
너 먹다 싶다 대로 마음껏 마시다|네가 먹고 싶은 대로 맘껏을 마셔라
사람 그 더 이상 없다 좋다|사람이야 더할 나위 없이 좋지
김 교수 정말 이것 시대의 학자|김 교수야말로 이 시대의 학자다
통일 정말 우리 받다 되다 최대|통일이야말로 우리에게 주어진 최대의 과업이지
형편 어렵다 되다 때문 친구하나 찾다 할 수 없다|형편이 어려워지니 친구라곤 하나도 찾을 수 없다
인정 것 눈곱도 없다 사람|인정이라고는 눈곱만큼도 없는 사람
남편 마저 미덥다 못하다|남편마저 미덥지가 못하다
나 김밥 것 먹다 싶다|나는 김밥이 먹고 싶다
그 말 백 도 더 말하다 같다|그 말은 백 번도 더 했잖니
그것 참 신통하다|그것 참 신통하군그래
앞으로 자주 만나다 부탁하다|앞으로는 자주 만납시다그려
새벽 곧 떠나다|새벽같이 떠난다
그 만나다 꼭 만 모든 문제 해결 할 수 있다|그를 만나야만 모든 문제가 해결될 수 있다
책 뜻 무엇 표지 보다 내용 더 중요하다|책이란 표지보다 내용이 더 중요하다
뒤+돌아보다 표정 안되다|뒤를 돌아보아선 안 돼
놀다 가다 도 멀리 가다 말다|놀러 가더라도 멀리는 가지 마라
한시간 도 쉬다 못하다|한 시간도 쉬질 못했어
전화를 받다 꼭 주문 것 받다|전화가 걸려를 와야 주문을 받지요
이제 범인 밝히다 되다|이제야 범인이 밝혀지는군
며칠 밤새우다 쯤 것 견디다 할수있다|며칠 밤새우는 것쯤이야 견딜 수 있다
8월 내내 비 하나 내리다 없다|8월 내내 비라고는 한 방울도 내리지 않았다
시장 것 마을 딱하나 밖에 없다|시장이라고는 마을에 딱 하나밖에 없었다
네 말 도대체 틀렸다|네 말은 도대체가 틀려먹었다
나 백두산 것 제일 보다 싶다|나는 백두산이 제일 보고 싶다
성적 그렇게 도 중요하다 물음표|성적이 그렇게도 중요한가
그 물건 자네 사다 말하다|그 물건 자네가 사겠다고 하지그래
자네 이야기 좀 부탁하다|자네가 이야기를 좀 하게나 그려
어머니 나에게 말하다 할아버지 허락 받다 꼭 만 하다|어머니는 할아버님께 허락을 받아야만 한다고 말씀하셨다
사람 뜻 무엇 제 분수 지키다 줄 알다 꼭|사람이란 제 분수를 지킬 줄 알아야 한다
바람 때문 꽃 지다|바람에 꽃이 진다
시골 아이 때문 그것 도 모르다|시골 아이라고 그것도 모르겠니
시험관 앞 때문 좀 긴장하다 아마|시험관 앞이라고 좀 긴장했나 봐
이것 고장 사과 때문 유명하다|이 고장은 사과로 유명하다
지각 때문 벌 받다|지각으로 벌을 받는다
이것 일 자네 꼭 감당 할 수 있다|이 일은 자네라야 감당할 수 있을 걸세
요즘 사람들 명절 이나 제사 때 만 고향 찾다 가다|요즘 사람들은 명절이나 제사 때라야만 고향을 찾아간다
마늘 다지다 꼭 음식 본래 맛 나다|마늘은 다진 것이라야 음식이 제 맛이 납니다
아버지 어머니 만들다 음식 꼭 만 먹다|아버지는 어머니가 만든 음식이라야만 드신다
폭우 때문 꽃 지다|폭우에 꽃이 진다
박사 때문 무엇 다알다|박사라고 무엇이든 다 아나?
시골 때문 약국 도 없다 줄 알다|시골이라고 약국도 없는 줄 아니?
오해 때문 싸움 벌어지다|오해로 인하여 싸움이 벌어졌다
가난 때문 학교 중간 그만두다|가난으로 말미암아 학교를 중간에 그만두었다
공사 끝나다 뒤 꼭 대금 지불 할 수 있다|공사가 끝난 뒤에라야 대금을 지불할 수 있다
이것 일 그사람 꼭 할 수 있다|이 일은 그 사람이라야 할 수 있다
그 이것 학교 교사 머무르다|그는 이 학교 교사로 있다
아버지 의 딸 부족 없다 생각|아버지의 딸로서 부족함이 없다고 생각한다
인간 맞다 그런데 어떻게 그것같다 가능|인간으로 어떻게 그럴 수가 있나
자식 입장 마땅하다 하다 일|자식으로서 마땅히 할 일
자식 훌륭하다 사람 키우다 끝|자식을 훌륭한 사람으로 키웠다
진눈깨비 변하다 비 되다|진눈깨비가 비로 변하였다
마음 더 없다 좋다|마음은요 더없이 좋아요
기차 참 빠르다 가다|기차가 참 빨리 가지요
그 이것 학교 영양사 머무르다|그는 이 학교 영양사로 있다
그 남편감 대로 부족 점 많다|그는 남편감으로서는 부족한 점이 많다
회원 가입하다 끝|회원으로 가입했다
사람 맞다 그런데 어찌 그런 일 할 수 있다|사람으로서 어찌 그런 일을 할 수 있나
영희 현숙하다 처녀 성장하다 끝|영희가 현숙한 처녀로 성장했다
어서 읽다 부탁하다|어서요 읽어 보세요
나 모르다|나를 모르겠어요?
한 시민 도둑 싸우다 그 도둑 잡다 끝|한 시민이 도둑과 싸워 그 도둑을 잡았다
그 맞서다 생각 말다|그와 맞서려 하지 마라
사소하다 오해 로 그 애인 헤어지다 끝|사소한 오해로 그는 애인하고 헤어졌다
나 하여금 정의 와 진리 위하다 헌신 하소서|나로 하여금 정의와 진리를 위해 헌신하게 하소서
동생 하여금 집안일 살피다 하다|동생으로 하여금 집안일을 보게 하였다
우리 햇볕 옷 말리다 끝|우리는 햇볕에 옷을 말렸다
이것 약 감기 낫다 순조롭다|이 약은 감기에 잘 듣는다
이것 문제 관하다 보고서 작성하다 오다 부탁하다|이 문제에 관한 보고서를 작성해 오시오
시대 뒤떨어지다 생각 말다|시대에 뒤떨어지는 생각은 하지 마라
아우 하나 있다 그런데 어리석다 마찬가지|아우라고 하나 있는 것도 어리석기는 마찬가지다
이것 도 일 하다 맞다|이것도 일이라고 했니
나 그 의견 찬성하다|나는 그의 의견에 찬성한다
나 화분 물 주다 끝|나는 화분에 물을 주었다
고래 물고기 아니다|고래는 물고기가 아니다
그 반지 것 절대 팔다 생각 말다|그 반질랑 아예 팔 생각 마라
이런 책 것 아이들 읽히다 말다|이런 책을랑 아이들에게 읽히지 마라
그 사람 부르다 말다|그 사람을랑은 부르지 마라
술 것 다시 마시다 말다|술일랑 다시 마시지 마라
폐품 것 다 창고 넣다|폐품일랑은 다 창고에 넣어라
나이 삼십 집 도 있다 차 도 있다|나이 삼십에 집도 있고 차도 있다
침묵 금 마찬가지|침묵은 금이다
하나 시민 범인 싸우다 그 범인 잡다 끝|한 시민이 범인과 싸워 그 범인을 잡았다
용감하다 검사 거대하다 폭력 조직 맞서다 끝|용감한 검사가 거대한 폭력 조직과 맞섰다
그녀 헤어지다 후 한동안 녀석 마음 잡다 못하다 끝|그녀와 헤어진 후 한동안 녀석은 마음을 잡지 못했다
너 더불다 이것 과업 완수하다 싶다|너로 더불어 이 과업을 완수하고 싶다
이것 어디 쓰다 물음표|이걸 어디에 쓸 것인가
이것 시장 선출 때 가장 중시하다 사항|이 점이 시장을 선출하는 데에 있어서 가장 중시되어야 할 사항이다
나 하루 두번 세수하다|나는 하루에 두 번씩 세수를 한다
3년 동안 이곳 농사 짓다 하지만 번번이 실패만 거듭하다|3년 동안 이곳에서 농사라고 지어 보았지만 번번이 실패만 거듭했다
아들 하나 있다 그런데 부모 속 그렇게 썩이다|아들이라고 하나 있는 것이 부모 속을 그렇게 썩이니
그 거짓말 속다 말다|그의 거짓말에 속지 마시오
동생 칭찬 듣다 것 공부 잘하다 때문 아니다|동생이 칭찬을 들은 것은 공부를 잘해서가 아니다
그사람 학생 아니다|그 사람은 학생이 아니다
돈 꾸어가다 달라다 얘기 것 내 나에게 말하다 말다|돈 꾸어 달라는 얘길랑 내 앞에서 꺼내지도 마라
그런 일 것 걱정하다 말다|그런 일을랑 걱정을 하지 마라
미련 것 두다 말다|미련일랑 두지 말자
고구마 굽다 도 먹다 삶다 도 먹다|고구마는 구워도 먹고 삶아도 먹는다
그 양심적|그는 양심적이다
산 곳 눈 내리다 들 곳 비 내리다|산엔 눈이 내리고 들엔 비가 내린다
그 과자 먹다 겪다 끝|그 과자를 먹어는 보았다
인생 짧다 예술 길다|인생은 짧고 예술은 길다
아들 부터 직접 전화를 받다 때문만나다 다름없다|아들에게서 직접 전화를 받았으니 만나는 거나 다름없다
그 대다 못하다|그에게다 댈 것이 못된다
나 어머니 얼굴 많다 닮다|나는 어머니랑 얼굴이 많이 닮았다
철수 영숙 동갑|철수는 영숙이랑 동갑이다
개 늑대 모습 비슷하다|개는 늑대와 비슷하게 생겼다
철수 너 닮다|철수는 너하고 닮았다
아버지 아들 모방 이어내림|그 아버지에 그 아들
그 누가 보다 걸음 빠르다|그는 누구보다도 걸음이 빠르다
이것 보다 어찌 더 나쁘다|이에서 어찌 더 나쁠 수가 있겠어
산 곳 서리 내리다 들 곳 이슬 내리다|산엔 서리가 내리고 들엔 이슬이 내린다
그 사람 누구 모르다 도 훌륭하다 젊은이|그 사람 누군진 몰라도 훌륭한 젊은이다
비 많이 내리다 아니다|비가 많이는 오지 않았다
같다 자매 하지만 저 언니 성격 다르다|같은 자매이지만 저는 언니랑은 성격이 달라요
이것 책 나 갖다 것 같다|이 책은 내가 갖고 있는 것과 같다
빠르다 것 번개 같다|빠르기가 번개와 같다
나 모자 그것 다르다|내 모자는 그것하고 다르다
그 나 보다 두살위|그는 나보다 두 살 위이다
죽다 부모 살다 돌아오다 도 이 보다 더 기쁘다 아니다 아마|죽은 부모가 살아 돌아온들 이에서 더 기쁘지는 않을 것이다
그것 아무나 에게나 묻다 할 수 없다|그런 걸 아무에게나 물어볼 수는 없잖아
그 문학 또 음악 모두 소질 있다|그는 문학이나 음악이나 모두 소질이 있다
그것 가지다|그것이나 가져라
자기 무슨 대장 되다 처럼 굴다|자기가 무슨 대장이나 되는 것처럼 굴더라
그녀 예쁘다 그리고 귀엽다 칭찬 매우 좋아하다|그녀는 예쁘다거나 귀엽다거나 하는 칭찬을 매우 좋아한다
배추 든지 무 든지 마음대로 주세요|배추든가 무든가 아무것이나 주세요
사과 든지 배 든지 다 좋다|사과든지 배든지 다 좋다
오늘 든지 내일 든지 상관없다|오늘이든 내일이든 상관없다
봄 든지 가을든지 한번 여행 다녀오다 꼭|봄이든지 가을이든지 한번 여행을 다녀와야겠다
그 돈 든지 명예 든지 연연하다 아니다|그는 돈이라든지 명예라든지 하는 것에 연연해하지 않는다
그것 아무나 에게나 맡기다 할수없다|그런 걸 아무에게나 맡길 수는 없잖아
예 또 이제 그 변하다 것 없다|예나 이제나 그는 변한 게 없다
산 또 들 모두 초만원|산이나 들이나 모두 초만원이다
자기 천재 되다 처럼 굴다|자기가 천재나 되는 것처럼 굴더라
공부하다 그리고 일하다 잡념 없애다|공부를 한다거나 일을 한다거나 하여 잡념을 없앤다
걷다 든지 달리다 든지 제 시간 만 오너라|걸어서든 달려서든 제 시간에만 오너라
무슨 일 든지 잘하다 자신 있다|무슨 일이든지 잘할 자신이 있다
시 든지 소설 든지 문학 관계 책 무엇 든지 읽다 싶다|시라든지 소설이라든지 문학에 관계된 책은 뭐든 읽고 싶다
나 아침 때 운동하다|나는 아침에 운동을 한다
이번 때 가다 아니다|이번에는 안가겠다
그 봄가을 때 보약 먹다|그는 봄가을로 보약을 먹는다
모임 날짜 이달 중순 때 정하다|모임 날짜를 이달 중순으로 정했다
서울 에 오다 올해 십 년 되다|서울에 온 지 올해로 십 년이 된다
자동차 면허 시험 보다 이번 일곱 번째 되다|자동차 면허 시험을 보는 것이 이번으로 일곱 번째가 된다
고향 떠나다 올해 20년 되다|고향을 떠난 지 올해로써 20년이 된다
운전면허 시험 떨어지다 이번 세 번째 되다|운전면허 시험에 떨어진 것이 이번으로써 세 번째다
오늘 따라 택시 잡다 못하다|오늘따라 택시도 안 잡힌다
책상 곳 꽃병 올려놓다|책상에다가 꽃병을 올려놓았다
책 어디 두다|책을 어디다 둘까
옷 먼지 묻다|옷에 먼지가 묻었다
그것 창고 곳 넣다 두다|그건 창고에다가 넣어 두어라
귀중품 집 곳 두다 좋다|귀중품은 집에다 두는 것이 좋다
이것 문제 너 로서 시작 되다|이 문제는 너로서 시작되었다
남쪽 햇빛 들어오다|남쪽으로서 햇빛이 들어온다
나 대낮 때 운동하다|나는 대낮에 운동을 한다
진달래 이르다 봄 때 피다|진달래는 이른 봄에 핀다
오늘 이후 규칙적 생활하다 꼭|오늘 이후로 규칙적으로 생활하겠다
시험 시간 한시간 제한하다|시험 시간을 한 시간으로 제한한다
시험 치다 이번 일곱번째 되다|시험을 치는 것이 이로써 일곱 번째가 됩니다
그날 따라 전화를 받다 많이|그날따라 전화가 많이 왔다
책상 어디 두다|책상을 어디다가 둘까요
나 시골 곳 살다|나는 시골에 산다
상자 여기 두다|상자는 여기에다가 둘까
아버지 보내다 편지|아버지에게서 온 편지이다
그 말 누구 나에게 말하다|그 말을 뉘게서 들었느냐
아마 여기 부터 두 시간 걷다 아마|아마 여기에서부터 두 시간은 걸어야 할 거야
고향 까지 서울 부터 천이리 되다|고향까지는 서울서부터 천 리나 된다
시험 해방 되다|시험으로부터 해방되었다
열두시 기준 승패 결정하다|열두 시를 기준으로 승패를 결정한다
그 약 먹다 부터 몸 좋다 되다|그 약을 먹고부터는 몸이 좋아졌다
그것 언니 에게 묻다 해보다|그것은 언니더러 물어봐
누가 너 에게 그 일 하다 말하다|누가 너보고 그 일을 하라고 그러더냐
친구들 에게 합격 사실 알리다|친구들에게 합격 사실을 알렸다
그것 나 다오|그것을 내게 다오
누구 에게 돕다 청하다 물음표|누구에게다 도움을 청할까
책임 그 둘이 맡기다|책임은 그 둘에게로 돌아갔다
선생님 께 인사 드리다 싶다|선생님께 인사를 올리고 싶습니다
이것 너 에게 주다 선물|이것은 너한테 주는 선물이다
그 책임 누구 에게 맡기다 물음표|그 책임이 누구한테로 돌아갈까
선생님 꾸중을 듣다|선생님에게 꾸중을 들었다
왜 나 너 잔소리 듣다 되다|왜 내가 네게 잔소리를 들어야 하지
선생님 야단을 맞다|선생님께 야단을 맞았다
가방 친구 에게 맡기다 끝|가방을 친구한테 맡겼다
친구 나에게 말하다 이야기|친구한테서 들은 이야기다
우리 아침 도서관 에서 만나다 꼭 끝|우리는 아침에 도서관에서 만나기로 하였다
우연 길거리 곳 친구 만나다 끝|우연히 길거리서 친구를 만났다
여기 곳 차 주차 말다|여기설랑 차를 세우지 마라
빨리 집 가다 가장 잠 싶다|빨리 집에 가설랑은 잠부터 자야겠다
외할머니 부터 편지 받다|외할머니로부터 편지가 왔다
친구 부터 생일 선물 받다|친구로부터 생일 선물을 받았다
한시 부터 두시 사이 그 부터 전화를 받다 아마|한 시에서부터 두 시 사이에 그에게서 전화가 올 것이다
한시 부터 공연 시작 되다 아마|한 시서부터 공연이 시작될 것이다
그사람 말하다 이야기|그 사람으로부터 나온 이야기
자정 기준 시간 정하다 끝|자정을 기준으로 시간을 정했다
그녀 나 에게 누구 질문을 받다|그 여자가 나더러 누구냐고 묻더군
누구 에게 말하다 물음표|누구보고 하는 소리야
돼지 에게 먹이 주다|돼지에게 먹이를 준다
무슨 일 나 에게 알다 줘|무슨 일인지 내게도 알려 줘
이 일 누구 에게 맡기다 지문자 ‘야’ 하다 모르다|이 일을 누구에게다 맡겨야 할지 모르겠다
갑자기 모두 관심 나 에게 쏠리다|갑자기 모두의 관심이 나에게로 쏠렸다
이 기쁘다소식 부모 께 제일 먼저 알다 드리다 싶다|이 기쁜 소식을 부모님께 제일 먼저 알려 드리고 싶어요
언니 한테 보내다 물건|언니한테 보낼 물건
모두 그 사람 몰려들다|모두들 그 사람한테로 몰려들었다
개 물리다|개에게 물리다
부모 용돈 타다 쓰다 있다|부모님께 용돈을 타서 쓰고 있다
선생님 한테 칭찬 듣다 기분 좋다 끝|선생님한테 칭찬을 들어 기분이 좋았다
형 소식 오다 끝|형한테서 소식이 왔다
이 물건 시장 사다 오다 끝|이 물건은 시장에서 사 왔다
시장 사다 물건 그런데 싸다 좋다|시장서 산 물건인데 싸고 좋다
모두 앉다 기다리다 끝|모두 앉아설랑 기다렸다
거기 담배 말다|거기설랑은 담배 피우지 마라
서울 오너라|서울로 오너라
나 광화문 발길 돌리다|나는 광화문으로 발길을 돌렸다
동생 방금 집 가다 끝|동생은 방금 집에 갔다
아주머니 밭 가다 말하다 이미 나가다 끝|아주머니는 밭에를 간다고 나가셨는데요
어린이들 내일 의 희망|어린이들은 내일에의 희망이다
서울 에서 대구 다음 부산 가다|서울에서 대구로 해서 부산에 갔다
홍콩 다음 미국 들어가다 예정|홍콩으로 해서 미국을 들어갈 예정이다
이것 기차 광주 출발 서울가다|이 기차는 광줄 출발해 서울로 간다
이것 버스 대구 출발 서울가다|이 버스는 대구를 출발해 서울로 간다
그녀 아침 일찍 서울 떠나다 끝|그녀는 아침 일찍 서울을 떠났다
학교 에서 집 까지 걷다 끝|학교에서 집까지 걸었다
서울 곳 전화를 받다 끝|서울서 전화가 왔다
직장 다니다|직장을 다닌다
동사무소 오너라|동사무소로 오너라
어디 가다 좋다 묻다|어디로 가는 것이 좋겠어요
미국 여행 떠나다|미국으로 여행을 떠난다
지금 산 가다|지금 산에 간다
집 가다 그런데 이모 오다 있다 끝|집에를 갔더니 이모가 와 있었다
해외 시장 의 진출 앞당기다 되다 같다|해외 시장에의 진출이 앞당겨질 것 같다
바람 나뭇가지 사이 빠져나가다|바람이 나뭇가지 사이로 빠져나간다
나 고향 떠나다|나는 고향을 떠난다
서울 곳 몇시 출발 예정 묻다|서울에서 몇 시에 출발할 예정이냐
너 지금 어디 오다|너 지금 어디서 오는 길이냐
회사 다니다|회사를 다닌다
시장 가다|시장을 간다
동생 함께 오다 끝|동생서껀 왔다
친구들 어울리다 늦다 까지 놀다|친구들과 어울려 늦게까지 놀았다
어제 친구 와 테니스를 치다|어제는 친구와 테니스를 쳤다
오늘 동생 과 싸우다 끝|오늘 동생이랑 싸웠다
지문자 영숙 아 이리 오다 해보다|영숙아 이리 와 봐
지문자 철수 야 어디 가다|철수야 어디 가니?
겨레 잠 깨다 시키다|겨레여 잠에서 깨어나라
슬프다 안녕|슬픔이여 안녕
전능자 시여 우리 자비 베풀다 주세요|전능자시여 우리에게 자비를 베풀어 주옵소서
하늘 이시여 우리 지키다 주세요|하늘이시여 우리를 지켜 주소서
조카 함께 오다 끝|조카서껀 함께 왔다
십년 오래간만 형님 함께 고향 다녀오다|십 년 만에 형님과 함께 고향에 다녀왔다
그 오랜만 아내 와 나들이하다|그는 오랜만에 아내와 나들이를 했다
동생 언니 싸우다|동생이 언니랑 싸우다니
두꺼비 아 두꺼비 아 헌 집 주다 새집 주세요|두껍아 두껍아 헌 집 줄게 새 집 다오
새 야 새 야 파랑새 야|새야 새야 파랑새야
주 시여 잘못 용서하다 주세요|주여 잘못을 용서하여 주소서
하늘 조국 보살피다 주세요|하늘이여 조국을 보살피소서
왕 자비 베풀다 주세요|왕이시여 자비를 베풀어 주소서
폐휴지를 이용한 생활용품전|폐휴질 이용해 생활용품을 만들었다
휘파람 신호 이용 그 부르다 끝|휘파람을 신호로 해서 그를 불렀다
꿀 가지다 단맛 나다|꿀로 단맛을 낸다
대화 가지다 갈등 풀다 할 수 있다|대화로써 갈등을 풀 수 있을까
약 가지다 병 치료하다|약으로 병을 고친다
그들 엄격하다 규칙가지다 아이들 잘못 바로잡다 주다 끝|그들은 엄격한 규칙으로써 아이들의 잘못을 바로잡아 주었다
콘크리트 가지다 집 짓다|콘크리트로 집을 짓는다
이 안경 유리 가지다 만들다 때문 무겁다|이 안경은 유리로 만들어서 무겁다
콩 가지다 메주 쑤다|콩으로 메주를 쑨다
남다 음식 이용하다 찌개 만들다 끝|남은 음식을 이용해 찌개를 만들었다
과일 칼 가지다 자르다|과일을 칼로 자른다
이제 눈물 가지다 호소하다 밖에 없다|이제는 눈물로써 호소하는 수밖에 없다
사진 가지다 설명하다|사진으로 설명을 한다
그 진실 꼭 이념 가지다 나라 다스리다 끝|그는 진실해야 한다는 이념으로써 나라를 다스렸다
선생님 시 백 정도 외우다 나에게 말하다|선생님은 시를 백 수나 외우신다더라
벌써 삼분의일 정도 끝|벌써 삼분의일 이나 끝냈다
시간 얼마 되다 물음표|몇 시나 되었을까?
나이 열 정도 되다 아마|열 살이나 되었겠다
이런 자전거 가지다 한 시간 백 리 가다 할 수 있다|이런 자전거로 어떻게 한 시간에 백 릴 가니
사과 둘 먹다 끝|사과를 두 개를 먹었다 
어제 열 시간 자다 끝|어제는 열 시간을 잤다 
그 평생 이르다 신념 잃다 아니다 살다 끝|그는 평생토록 신념을 잃지 않고 살았다
돈 있다 때문 남 깔보다 되다|돈깨나 있다고 남을 깔보면 되겠니
이것 정도 물건 얼마 든지 구하다 할 수 있다|이만 물건은 얼마든지 구할 수 있다
눈곱 정도 도 모르다 끝|눈곱만치도 몰랐다
집 대궐 정도 크다 짓다|집을 대궐만큼 크게 짓는다
집 정도 크다 파도 몰려오다|집채만 한 파도가 몰려온다
사위 오다 때문 닭 얼마잡다 끝|사위가 온다고 닭 마리나 잡았지
그 사람 돈 얼마 있다 때문 거만하다|그 사람은 돈푼이나 있다고 거만하다
선생님 수학 공식 백 정도 외우다 나에게 말하다|선생님은 수학 공식을 백 개나 외우신다더라
어떻게 앉다 곳 달걀 다섯 정도 먹다 묻다|어떻게 앉은 자리에서 달걀을 다섯 개나 먹었느냐
그녀 퍽 상냥하다|그녀는 퍽이나 상냥했다
몇 되다 물음표|몇이나 될까
한시간 백 킬로미터 가다|한 시간에 백 킬로미터를 갑니다
그 우리 반 으뜸이다|그는 우리 반에서 으뜸을 달린다
우리 영원 이르다 함께 하다 약속|우리는 영원토록 함께하기로 했다
얼굴 보다 심술 부리다 같다|얼굴을 보니 심술깨나 부리겠더구나
그것 정도 일 가지다 호들갑 떨다 그 이해 할수없다|그만 일을 가지고 호들갑을 떠는 그를 이해할 수 없다
나 도 너 정도 먹다 끝|나도 너만치 먹었다
나 도 당신 정도 할수있다|나도 당신만큼은 할 수 있다
청군 백군 보다 지다|청군이 백군만 못하다
나잇살 얼마 먹다 사람 점잖다 못하다 이것 무슨 짓 묻다|나잇살이나 먹은 사람이 점잖지 못하게 이게 무슨 짓이오
포유동물 중 무엇 있다|포유동물에 무엇이 있지
지문자 영희 그녀 무슨 일 생기다 물음표|영희에게 무슨 일이 생겼을까
너 아무 잘못 없다|네게는 아무 잘못도 없다 
우리 사장님 께 그 정도 돈 있다 묻다|우리 사장님께 그만한 돈이 있겠습니까
나 돈 좀 있다|나한테 돈이 좀 있다
이곳 찾다 오다 못하다 아마|이곳에야 찾아오지 못하겠지
동생 역 까지 바래다주다 끝|동생을 역까지 바래다주었다
아내 웃다 만 아무 말 없다|아내는 웃기만 할 뿐 아무 말이 없다
곤충 중 무엇 있다|곤충에 무엇이 있지?
이곳 생산하다 것 중 좋다 것 있다 듣다|이곳에서 생산되는 것에 좋은 것이 있다고 들었소
철수 에게 돈 많다|철수에게 돈이 많다
형님 께 무슨 일 생기다 묻다|형님께 무슨 일이 생겼나요
너 색연필 있다|너한테 색연필 있니
정오 가깝다 시각 잠자리 일어나다|정오가 가까운 시각에야 잠자리에서 일어났다
그 병원 열두시 부터 한시 까지 점심시간|그 병원은 열두 시부터 한 시까지가 점심시간이다
하루 잠자다 만 때문 머리 띵하다|하루 종일 잠만 잤더니 머리가 띵하다
커피 더 설탕 타다|커피에 설탕을 탄다
누가 술 더 물 섞다|누가 술에다가 물을 탔다
물 더 밥 말다 먹다 끝|물에다 밥을 말아 먹었다
책상 두다 어디|책상을 어디다가 둘까요
친구 함께 영화 보다 밥 도 먹다 끝|친구와 영화를 보고 밥도 먹었다
막내 까지 출가하다 때문 허전하다|막내마저 출가를 시키니 허전하다
이번 달 월급 더 수당 받다|이번 달에는 월급에다가 수당도 받는다
백원 더 백원 더하다 때문 이백원 되다 끝|백 원에다 백 원을 더하니 이백 원이 되었다
아이 모형 비행기 저렇게 까지 좋아하다 줄 모르다|아이가 모형 비행기를 저렇게까지 좋아할 줄은 몰랐어
시간 없다 때문 세수 도 못하다 오다 끝|시간이 없어서 세수도 못하고 왔다
찬밥 도 좋다 때문 빨리 먹다 주세요|찬밥도 좋으니 빨리만 먹게 해 주세요
그 편지 커녕 자기 이름 도 쓰다 못하다|그는 편지는커녕 제 이름조차 못 쓴다
나 같다 나그네 가다 못하다 곳 어느|나 같은 나그네가 어느 곳엔들 못 가랴
아이 된장찌개 저렇게 까지 좋아하다 줄 모르다|아이가 된장찌개를 저렇게까지 좋아할 줄은 몰랐어
열장 복권 중 하나 만 당첨 되다 도 바라다 것 없다|열 장의 복권 중에서 하나만 당첨되어도 바랄 것이 없다
한순간 도 마음 놓다 못하다|한순간도 마음을 놓지 못한다
어찌 꿈 속 도 잊다 할수있다 물음표|어찌 꿈엔들 잊을 수 있겠소
먼발치 그러나 보다 되다 기쁘다 끝|먼발치로나마 보게 되어 기뻤다
영화 보다 싶다 그러나 시간 없다|영화를 보고는 싶지마는 시간이 안 난다
나이 늙다 그러나 마음 여전히 청춘|나이는 들었지만 마음은 여전히 청춘이다
배고프다 그런데 풀 뿌리 먹다 못하다 물음표|배가 고픈데 풀뿌린들 못 먹을까
밤낮 일 때문 병나다 아니다 묻다|밤낮으로 일하니 병인들 안 날쏘냐
비 커녕 구름까지 없다|비커녕 구름조차 끼지 않는다
그 고맙다 커녕 알다 척하다 아니하다|그 녀석 고마워하긴커녕 아는 체도 않더라
빨리 커녕 천천히 걷다 못하다|빨리는커녕 천천히도 못 걷겠다
돈 천 커녕 백 도 없다|천 원은커녕 백 원도 없다
너 덕 늦다 그러나 일 마치다 할수있다|네 덕에 늦게나마 일을 마칠 수 있었다
반찬 없다 밥 그러나 많이 자시다|반찬 없는 밥이나마 많이 자시게
먹다 싶다 그러나 돈 없다|먹고는 싶다만 돈이 없다
너 얼굴 꿈 속 도 잊다 못하다|네 얼굴을 꿈엔들 잊을쏘냐
네 마음 오죽하다|네 마음인들 오죽하겠니?
밥 커녕 죽 도 먹다 못하다|밥커녕 죽도 못 먹는다
하루 국수 커녕 물 한모금 마시다 못하다|하루 종일 국순커녕 물 한 모금도 못 마셨다
술값 커녕 차비 도 없다|술값은커녕 차비도 없다
가볍다 때문 어린이 도 들다 할 수 있다|가벼워서 어린애라도 들 수 있다
아무리 선생님 도 모르다 것 있다|아무리 선생님이라도 모르는 것이 있다
새끼 중 예쁘다 아니다 것 없다|새끼치고는 예쁘지 않은 것이 없다
겨울 날씨 그러나 따뜻하다|겨울 날씨치고 따뜻하다
서양 사람 그러나 키가 작다|서양 사람치고는 키가 작다
우리 학교 학생 중 그 모르다 사람 없다|우리 학교 학생치고서 그를 모르는 사람은 없다
너 신문 도 읽다 아니다|너는 신문도 안 읽니?
나 알아주다 사람 너 밖에 없다|나를 알아주는 사람은 너밖에 없다
여기 어디 함부로 까불다 묻다|여기가 어디라고 함부로 까부느냐?
누구 감히 당신 말 어기다 묻다|누구라고 감히 당신 말을 어기겠소
부모 중 자식 사랑하다 아니다 사람 없다|부모치고 자식을 사랑하지 않는 사람 없다
젊다 사람 중 점잖다|젊은 사람치고는 점잖다
집 앞 까지 가다 도 그냥 오다 끝|집 앞까지 갔다가도 그냥 왔지요
하나 밖에 남다 아니다|하나밖에 남지 않았다
눈 같다 희다 박꽃|눈같이 흰 박꽃
동태 처럼 얼다 끝|동태처럼 얼었다
크다 것 크다 것 대로 따로 모으다 두다|큰 것은 큰 것대로 따로 모아 둔다
마당 화초 심다 결심하다 끝|마당에 화초를 심기로 결심했다
사람 마다 성격 다르다|사람마다 성격이 다르다
자네 말 대로 극 과 극 통하다 법|자네 말마따나 극과 극은 통하는 법이지
믿다 것 실력 뿐|믿을 것은 실력뿐이다
이것 무더위 때 지내다 어떻게|이 무더위에 어떻게 지냈니
반장 그 뽑히다 끝|반장에 그가 뽑혔다
고맙다 마음 가지다 드리다 말씀|고마운 마음에서 드리는 말씀입니다
상 커녕 벌 받다 끝|상커녕 벌을 받았다
우리 의 학교|우리의 학교
나라 의 발전|나라의 발전
나 의 작품|나의 작품
승리의 길|승리의 길
자연 의 관찰|자연의 관찰
한국 의 지도|한국의 지도
책 의 저자|책의 저자
아버님 신문 보다|아버님께서 신문을 보신다
이것 책 나 동생 빌리다 오다|이 책은 내 동생이 빌려 왔다
저것 아이 또 왜 저렇게|저 앤 또 왜 저래?
학생 의 도리 다 하다|학생의 할 도리를 다한다
안녕하세요|안녕들 하세요?
나 찾다 사람 없다 그런데 그 누구 나 찾다 물음표|날 찾을 이가 없건마는 그 뉘라서 날 찾나
어떤 사람 이것 고통 감당 가능 물음표|어떤 사람이라서 이 고통을 감당하겠는가
나 친구 책 많다|내 친구는 책이 많다
아버지 도 저것 종 듣다|아버지도 저 종소리가 들리세요
참다운 친구 무엇 어렵다 때 돕다 친구|참다운 친구란 어려울 때 도와주는 친구야
아버지 도 저것 박 수 듣다|아버지도 저 박수 소리가 들리세요
오늘 날씨 덥다|오늘은 날씨가 덥다
달 밝다|달이 밝다
우리 학교 우승 차 지하다|우리 학교에서 우승을 차지했다
아이 둘 그리고 나  합 셋 길 나서다|아이 둘과 나 이렇게 셋이서 길을 나섰다
내일 일 누구 알다  물음표|내일 일을 뉘라서 알리오
선생님 숙제 받다|선생님께서 숙제를 내주셨다
나 학생|난 학생이다
나 거치다 없다 바 다 사나이|나는 거칠 것 없는 바다의 사나이다
기선 증기 힘 가지 다 항해하다|기선은 증기의 힘으로 달리다
설악산 으로 꽃놀이 가다 끝|설악산으로 꽃놀이를 갔다
마중 가다|마중을 간다
잠 자다|잠을 잔다
이것 편지 형 보여 주다|이 편지 형을 보일까요
오리 키우다|오릴 친다
친구 들 과 단풍놀 이 가다 끝|친구들과 단풍놀일 갔다
낚시 가다|낚시를 간다
구경 가다|구경을 간다
꿈꾸다|꿈을 꾼다
이것 그리다 무엇|이것은 무얼 그린 거냐
이것 시계 애인 보 여 주다|이 시계 애인을 보일까요
어머니 그리고 언니  다 직장 다니다|어머니하고 언니하고 다 직장에 다닌다
아내 나에게 묻다 낙엽 밟다 소리 좋다|아내는 나더러 낙엽 밟는 소리가 좋으냐고 물었다
서울 눈 많다 내리다 아마|서울에는 눈이 많이 내렸다나 어쨌다나
요리사 많다 드세요  권하다|요리사가 많이 드세요라고 권한다
그 먹보 떡 도 좋다  나에게 말하다 때 알 다 되다|그 먹보가 떡도 좋지라 할 때는 알아보았어야지
팻말 금지구역 쓰다  있다 끝|팻말에는 ‘금지구역이라고 쓰여 있었다
아직 도 너 잘하다  생각하다|아직도 네가 잘했다고 생각하느냐
나에게 자기 대신  가다 아마|나더러 자기 대신 가라나 어쩌라나
이야기 옳다|이야긴즉 옳다
말씀 지당하다 하지 만 그대로 하다 어렵 다|말씀인즉 지당하지만 그대로 하기는 어렵습니다
얼음장 같이 차갑다  방바닥|얼음장같이 차가운 방바닥
아이 처럼 좋아하다|아이처럼 좋아한다
나 나 대로 하다|나는 나대로 한다
그 내일 만나다 약 속하다 끝|그와 내일 만나기로 약속했다
날마다 책 읽다|날마다 책을 읽는다
자네 말 대로 쉬다  좋다 같다|자네 말마따나 쉬는 게 좋겠네
눈 만 감다 도 잠자 다 같다|눈만 감아도 잠이 올 것 같다
가지다 것 돈 뿐|가진 것은 돈뿐이다
기쁨 넘치다 나날|기쁨에 넘치는 나날이었다
춘향 맡다 성희 이 도령 맡다 춘수|춘향에 성희 이 도령에 춘수였다
그저 조그마하다 보 탬 되다 싶다 뜻 가 지다 행하다 일|그저 조그마한 보탬이라도 되고자 하는 뜻에서 행한 일이다
10년 의 세월|10년의 세월
국민 의 대다수|국민의 대다수
불후 의 명작|불후의 명작
철 의 여인|철의 여인
순금 의 보석|순금의 보석
건설 의 역사|건설의 역사
저자 와 대화|저자와의 대화
1시간 늦다 말 되다|1시간이나 늦게 온다는 게 말이 되요
가깝다 연락 부탁|이 근처에 오시면 연락을 주세요
가방 안 중요하다 것 있다|가방 안에 중요한 게 있어요
가습기 하나 사다 생각 중|가습기를 하나 살까 생각 중이에요
갈다 타다 어디|어디에서 갈아타요
감사합니다 어서 오세요|감사합니다 어서 오세요
갓난아기 때 엄마 손 많다 필요하다 아마|갓난아기 때에는 엄마의 손이 많이 갈 거예요
강원도 설악산|강원도에 있는 설악산이요
개학하다 전 돌아오다|개학하기 전에는 돌아올 거예요
걱정 말다 다르다 학생들 도 잘 지내다 있다|걱정 말아요 다른 학생들도 잘 지내고 있어요
게다가 시험 도 잘 보다 같다|게다가 시험도 잘 본 것 같아요
겪다 하지만 효과 없다|해 봤지만 별 효과가 없었어요
결혼 아직 말하다|아직 미혼이라고 하던데요 
결혼 아직 멀다|결혼하려면 아직 멀었어요
결혼식 언제|언제 결혼식을 합니까
경복궁 또 창경궁 같다 고궁 어떠하다|경복궁이나 창경궁 같은 고궁은 어때요
고맙다 덕분 용기 생기다|고마워요 덕분에 용기가 생겼어요
고맙다 많다 도움을 받다 되다|고마워요 많은 도움이 되었어요
고맙다 잘 쓰다|고마워요 잘 쓸게요
곧 장마 시작 되다 말하다|곧 장마가 시작된대요
공부 힘들다|공부가 힘들어요
과거 부터 시간 있다 마다 낚시 겪다|전부터 시간이 있을 때마다 낚시를 했어요
괜찮다 같다|괜찮아요 그럴 수도 있지요
괜찮다 탈의실 저쪽|그럼요 탈의실은 저 쪽입니다
괜히 짜증 그 사람 이해 할 수 없다|괜히 짜증을 내요 그 사람을 이해할 수 없어요
교수 직접 연락 주다 못하다 죄송하다|교수님께 직접 연락을 드렸어야 하는데 죄송합니다
그 때 사람들 글 배우다 쉽다 아니다 아마|그 때는 사람들이 글을 배우기가 쉽지 않았을 거예요
그 때 약속 지키다 맞다|그 때는 약속 시간을 지키실 거죠
그 사람 함께 잘 되다 바라다|그 분과 잘 되기를 바랍니다
그 사람들 왜|그 사람들이 왜요
그 아이 부모 이혼하다 끝|그 아이의 부모는 이혼했다 
그것 사이즈 매진되다 없다|그 사이즈는 모두 팔리고 없어요
그곳 좋다 무엇|그곳은 뭐가 좋은가요
그곳 지금 단풍 한창|그 곳은 지금 단풍이 한창이지요
그녀 선량하다 남자  결혼하다|그녀는 선량한 남자와 결혼한다 
그녀 연하 남자 결혼하다 끝|그녀는 연하의 남자와 결혼했다 
그동안 연애하다 드디어 결혼하다 같다|그동안 연애를 하더니 드디어 결혼을 하나 봐요
그래도 대화 로 감정 풀다|그래도 대화로 감정을 풀어야지요
그래도 하루 우울|그래도 하루 종일 우울했어요
그래서 대답하다 무엇|그래서 뭐라고 대답했어요
그래서 세종대왕 한글 새롭다 만들다|그래서 세종대왕이 한글을 새로 만든 거예요
그래서 작년 부터 저축하다 중|그래서 작년부터 저축을 하고 있어요
그래서 저 운동하다 빼다 생각하다|그래서 저는 운동을 해서 빼려고 해요
그래서 친구들 인기가 많다|그래서 친구들에게 인기가 많습니다
그러면 가을 때 함께 여행 가다|그러면 가을에 함께 여행을 가요
그러면 거만하다 보이다 아니다|그러면 좀 거만해 보이지 않을까요
그러면 교통 정체 심하다 아마|그러면 교통 정체가 심하겠군요
그러면 버스 타다 어떠하다|그러면 버스를 타는 것은 어때요
그러면 언제 돌아오다|그럼 언제 돌아오세요
그러면 운동 좀 해보다|그러면 운동을 좀 해 보세요
그러면 이것 주세요|그럼 이것으로 주세요
그러면 저 같이 배우다|그러면 저하고 같이 배워요
그러면 저 더 멀리하다 할까봐 겁나다|그러면 저를 더 멀리 할까봐 겁이나요
그러면 주말 또 만나다|그러면 주말에 또 만나요
그러면 추석 날 무엇 하다|그러면 추석날 뭐 할 거예요
그러면 춥다 겨울 좋아하다 아마|그러면 추운 겨울을 좋아하나 봐요
그러면 카드 하다|그러면 카드로 결재할게요
그러면 혹시|그러면 혹시
그러면 환불 되다|그러면 환불이 되나요
그런 각각 의미 무엇|그런 것은 무슨 의미가 있나요
그런 말 듣다 때문 기운나다|그런 말을 들으니까 기운이 나네요
그런 활동 저 어렵다 아마|그런 활동은 저는 좀 하기가 어렵겠어요
그럼 다음 주 연락 드리다 꼭|그럼 다음 주에 꼭 연락드릴게요
그렇지만 다르다 모임 다르다 보다 활동적 때문 좋다|그렇지만 다른 모임과 달리 활동적이라서 좋아요
그저께 여기 곳 옷 사다 그런데 교환하다 싶다|그저께 여기서 옷을 샀는데 교환하고 싶어요
글쎄 계획 바꾸다 좋다 같다|글쎄요 계획을 바꾸는 게 좋겠어요
글쎄 올해 가다 말다 망설이다 중|글쎄요 올해는 갈까 말까 해요
기저귀 젖병 유모차 포대기 장난감 여러 가지 준비하다|기저귀 젖병 유모차 포대기 장난감 등을 준비해요
김 조교 얼굴 빨갛다 왜|김 조교 왜 얼굴이 빨개요
나 그녀 청혼하다 끝|나는 그녀에게 청혼했다 
나 말 딱맞다|그럴 줄 알았어요
나 보다 때 소라 훌륭하다 신부 되다 같다|내가 보기에 소라씨는 훌륭한 신부가 될 것 같아요
나 연락 받다 못하다|나는 연락을 받지 못했습니다
낚시 좋다 무엇|낚시는 어떤 점이 좋아요
날씨 춥다 아니다 그런데 감기 걸리다 되다|날씨도 춥지 않은데 감기에 걸렸어요
낮 커피 많다 마시다|낮에 커피를 많이 마시나요
내일 바쁘다 아니다|내일 바쁘지 않으세요
내일 병원 가다 되다|내일은 병원에 가야겠어요
내일 시험 그런데 아이들 뛰다 소리 크다 때문 집중 안되다|내일이 시험인데 아이들 뛰는 소리가 커서 집중이 안되요
내일 지하철 출근 아마|내일은 지하철로 출근해야겠어요
내일 추석 고향 가다 아니다|내일이 추석인데 고향에 안 갔어요
냉정하다 모습 하지만 마음 따뜻하다 사람|냉정하게 생겼지만 마음은 따뜻한 사람이에요
너무 걱정 말다 찾다 할 수 있다 아마|너무 걱정하지 말아요 찾을 수 있을 거예요
너무 긴장하다 때문 운전 못하다|너무 긴장이 돼서 운전을 못하겠어요
노력 해보다|노력 해볼게요
누구 때문|누구 때문에 그러는데요
눈 내리다 정도|눈이 얼마나 내렸는데요
눈 많다 내리다|눈이 많이 내렸다면서요
다 좋다 말하다 끝|뭐든지 좋다고 했어요
다르다 생각 중 때문|다른 생각을 좀 하느라고요
다시 실수 없다 꼭|다시는 이런 실수 없도록 하겠습니다
다음 주 계획 무엇|민수씨 다음 주 계획은 뭐예요?
다음 주 미국 어학 연수 가다 예정|다음 주에 미국으로 어학연수를 갈 예정이에요
다음 주 부터 시작하다|다음 주부터 시작합시다
다음 주 월요일 부산 출장 가다 할 수 있다|다음 주 월요일에 부산에 출장 갈 수 있어요?
다음 주 중요하다 시험 있다 때문|다음 주에 중요한 시험이 있어서 그래요
다이어트 어렵다 말하다 끝|다이어트는 어렵다고 했잖아요
담배 때문 아마|담배 때문인가 봐요
대단히 죄송하다|어떻게 사과를 드려야 할지 모르겠군요
대답 잘 못하다 같다|대답을 잘 하지 못한 것 같아요
대부분 인터넷 쇼핑 하다|대부분 인터넷 쇼핑에서 물건을 삽니다
대학 동창 청첩장 받다 끝|대학 동창한테서 청첩장을 받았어요
댄스 배우다 해보다|댄스를 배워보실래요
도대체 사람 왜|도대체 사람이 왜 그 모양이에요
돌잔치 상 놓다 물건 무엇|돌잔치 상에는 어떤 물건을 놓아요
동대문 역사 문화 공원 4호선 갈다 타다 부탁하다|동대문역사문화공원 역에서 4호선으로 갈아타세요
동아리 회원들 대하다 알다 싶다|동아리 회원들에 대해 알고 싶어요
동창 초대장 받다|동창한테서 초대장을 받았어요 
돼지 꿈 겪다|돼지꿈이라도 꾸셨어요
등산 취미|취미로 등산을 한다면서요
또 다르다 부탁 없다|또 다른 부탁은 없어요
또 좋다 어디|또 어디가 좋을까요
마음 두다 말다 부탁하다|마음에 담아 두지 마세요
많다 쓰다 같다|조금 많이 드는 것 같아요
많다 아프다 말하다|많이 아프대요
말다 내일 저녁 저희 집 오다 부탁하다|그러지 말고 내일 저녁에 저희 집에 오세요
맞다|물론이지요
맞다 같다|네 그렇습니다
맞다 그것 때문 이것 집 이사 오다 끝|네 그것 때문에 이 집으로 이사 왔어요
맞다 날씨 너무 건조하다 같다|네 날씨가 너무 건조한 것 같아요
맞다 내일 출근길 혼란 예상 되다|네 내일 출근길 혼란이 예상 되요
맞다 담배 건강 아주 나쁘다|맞아요 담배는 건강에 아주 나쁘잖아요
맞다 더 자신 말하다 못하다 후회되다|네 좀 더 자신 있게 말하지 못한 것이 후회 되요
맞다 몸 그리고 마음 건강 위하다 취미 생활 꼭 필요하다|맞아요 몸과 마음의 건강을 위해 취미 생활은 꼭 해야해요
맞다 무슨 고민 있다 아마|맞아요 무슨 고민이 있나 봐요
맞다 바쁘다 가다 못하다|네 바빠서 못 갔어요
맞다 방 구경 할 수 있다|네 방을 구경할 수 있을까요
맞다 방학 금세 끝나다 줄 모르다|맞아요 방학이 이렇게 금세 끝날 줄 몰랐어요
맞다 아침 일찍 일어나다 할 수 없다|그래요 아침에 일찍 일어날 수가 없어요
맞다 어제 꿈 돼지 많다 나타나다|네 어제 꿈에 돼지가 수십 마리 나타났어요
맞다 영수증 있다|네 영수증은 있어요
맞다 오랫동안 데이트하다|네 오랫동안 데이트를 해 왔어요
맞다 요즘 원하다 직업 얻다 힘들다|그래요 요즘은 원하는 직업을 얻기가 힘들어요
맞다 우리나라 산 모두 가다 겪다|네 우리나라 산은 모두 가 봤어요
맞다 지금 살다 곳 생활비 적다 그런데 불편하다 것 많다|네 지금 사는 곳이 생활비는 적게 드는데 불편한 게 많아요
매주 화요일 아침 분리수거 하다|매주 화요일 아침에 분리수거를 하고 있어요
면접 때 어떤 옷 입다 가다|면접 때 어떤 옷을 입고 가야 할까요
면접 잘 끝|면접은 잘 끝냈어요
면접관 질문 무엇|면접관이 어떤 질문을 했어요
몇 번 떨어지다 때문 낙심하다 어떠하다|몇 번 떨어졌다고 그렇게 낙심하면 어떻게 해요
모두 좋다 사람들|모두 좋은 사람들이에요
목소리 도 조금 변하다 같다|목소리도 조금 변한 것 같아요
몸살 나다 때문 오다 못하다|몸살이 나서 나오지 못한대요
무슨 기분 나쁘다 일 있다|무슨 기분 나쁜 일이 있어요
무슨 언짢다 일 있다|무슨 언짢은 일이 있어요
무슨 오해 있다|뭔가 오해가 있었어요
무슨 요일 가능하다|무슨 요일이 가능해요
무슨 일 물음표 솔직히 말 해보다|무슨 일인지 솔직히 말해 봐요
무슨 일 오다|무슨 일로 오셨어요
무엇 일 원하다 질문을 받다|무슨 일을 하고 싶으냐고 물어봤어요
문제 무엇|뭐가 문제인데요
물건 도 많다 주차 도 편하다 그리고 점원 친절하다|물건도 많고 주차도 편하고 점원이 친절하잖아요
미나 무슨 일|미나씨는 무슨 일을 하세요
미나 이번 설날 고향 가다 아니다|미나씨는 이번 설날에 고향에 안 가요
미안하다 벌써 주의 시키다 있다|미안해요 그렇지 않아도 주의를 주고 있었어요
민수 기침 심하다|민수씨 기침이 심하군요
민수 멋지다 자동차 사다 끝|민수씨는 멋진 자동차 샀어요
민수 무슨 고민 있다|민수씨 무슨 고민 있어요
민수 성격 어떠하다|민수씨는 성격이 어때요
민수 어제 시험 결석 왜|민수군은 어제 시험에 왜 결석했나요
민수 할 수 있다|민수씨는 할 수 있어요
민호 올해 소망 무엇|민호씨는 올해 소망이 무엇이에요
발목 다치다 같다|발목을 다친 것 같아요
방학 그런데 도서관 무엇하다|방학인데 도서관에서 뭐하세요
방학 너무 짧다|방학이 너무 짧지요
방학 동안 계획 다 끝|방학 동안에 계획한 일은 다 했어요
방학 동안 어떻게 지내다|방학 동안 어떻게 지냈어요
방학 중 때문 별로 바쁘다 아니다|방학 중이라 별로 바쁘지 않아요
백화점 상품권|백화점 상품권으로 하려고요
백화점 주로 가다 왜|백화점에 주로 가는 이유가 있나요
백화점 카드 무이자 삼개월 할부 되다|백화점 카드로 무이자 3개월 할부됩니다
벌써 떨어지다 두 번|벌써 두 번이나 떨어졌는걸요
본의 아니다 실수하다 죄송하다|본의 아니게 실수를 했습니다 죄송합니다
부르다 대답 없다 왜|왜 불러도 대답이 없어요
부모 허락 받다 결혼하다 끝|부모의 허락을 받아 결혼하였다 
부탁 무슨|무슨 부탁인데요
부탁 있다|부탁이 있어요
비 내리다 모양 하늘 흐리다 되다|비가 내릴 모양이에요 하늘이 흐렸어요
사내 동호회 가입하다 생각하다 중|사내 동호회에 가입할까 해요
사람들 가장 많다 즐기다 취미 무엇|사람들이 가장 많이 즐기는 취미는 뭘까요
사람들 벌써 기차표 예매하다 중|사람들이 벌써 기차표를 예매하고 있어요
사실 절친하다 친구 싸우다|사실은 절친한 친구와 싸웠어요
산 가깝다 때문 공기 깨끗하다|산이 가까워서 공기가 깨끗해요
삼십분 미리 가다 할 수 있다|30분 안에 갈 수 있습니다
새해 특별 계획 있다|새해에는 특별한 계획이 있어요
생각하다 무엇|뭘 그렇게 생각하고 있어요
서른살 되다 그러나  결혼 못하다|서른 살이 되었지만 아직 결혼을 하지 못했다
서울 적설량 이십 센티미터|서울의 적설량은 20cm래요
선물 이니 예쁘다 포장하다 주세요|선물할 것이니 예쁘게 포장해 주세요
선물 준비하다 무엇|선물은 무엇을 준비할까요
소라 결혼 아직 왜|소라씨는 왜 아직 결혼을 안 했어요
소라 덥다 여름 좋아하다|소라씨는 더운 여름을 좋아하세요
소라 돌 때 집다 무엇|소라씨는 돌 때 무엇을 집었어요
소라 쇼핑하다 주로 어디|소라씨는 쇼핑을 주로 어디에서 해요
소라 취미 무엇|소라씨는 취미가 무엇입니까
수요일 아침 9시 공항 곳 만나다|그러면 수요일 아침 9시에 공항에서 만납시다
숙박 어떻게|숙박은 어떻게 하지요
스트레스 다 풀다 되다 같다|스트레스가 다 풀리는 것 같아요
시간 그리고 비용 얼마 쓰다|시간과 비용은 얼마나 듭니까
신랑 신부 반지 주고받다|신랑과 신부가 반지를 주고받는다 
신부 살림 장만하다|신부가 살림을 장만한다 
실례 하지만 연락처 알다 받다|실례지만 연락처 좀 가르쳐 주실래요
실수하다 무엇|무슨 실수요
십만원|10만원입니다
싶다 일 말하다 좋다|하고 싶은 일을 말하지 그랬어요
쌀 돈 국수 대추 책 연필 여러 가지 놓다|쌀 돈 국수 대추 책 연필 등을 놓아요
아기 양육 용품 준비하다 무엇|육아 용품으로 어떤 것을 준비하나요
아기 필요 일 무엇|아기에게 필요한 일은 무엇인가요
아니다|그렇지 않아요
아니다 가다 중 한번 갈다 타다 되다|아니요 가다가 한 번 갈아타야 합니다
아니다 더위 많다 타다 때문 여름 싫어하다|아니요 더위를 많이 타서 여름을 싫어해요
아니다 살 빼다 생각하다 오히려 체중 5kg 더 늘다|아니요 살을 빼려고 했는데 오히려 체중이 5kg 더 늘었어요
아니다 아직 못하다|아니요 다 하지 못했어요
아니다 운전면허 시험 합격하다 아직|아니요 아직 운전면허 시험에도 합격하지 못했어요
아니다 잘 맞다|아니요 잘 맞아요
아니다 전세|아니요 전세예요
아니다 짝사랑 사람 있다|아니요 짝사랑하는 사람이 있어요
아니다 힘들다 보다 지치다 때문|아니요 힘들다기보다는 좀 지쳐서요
아르바이트 무슨|무슨 아르바이트인데요
아무리 바쁘다 운동하다 꼭|아무리 바빠도 운동은 꼭 해야 합니다
아이 먼저 집다 보다 장래 알다 보다|아이가 먼저 집는 것을 보고 장래를 알아보는 거예요
아침 일찍이 차례 후 성묘 가다 아마|아침 일찍 차례 지내고 성묘하러 갈 거예요
안녕하세요 거기 카센터 맞다|여보세요 거기 카센터입니까
안녕하세요 아래 집 살다 대학생|안녕하세요 아랫집에 사는 대학생입니다
안녕하세요 앞 집 이사 오다 끝|안녕하세요 앞집에 이사 왔어요
안전선 뒤 물러가다 부탁하다|안전선 뒤로 물러서세요
알다 그러면 기회 한번 주다|알았어요 그럼 한번 기회를 주지요
앞으로 무엇 하다 물음표 생각하다 중 싶다 일 있다|앞으로 무엇을 할까 생각하고 있어요
앞으로 잘 부탁하다|앞으로 잘 부탁드립니다
앞으로 주의하다 꼭|앞으로 주의할게요
앞으로 친하다 지내다|앞으로 친하게 지내요
어디|어디요
어디 멀다 가다|어디 멀리 가세요
어떤 것 바꾸다 주다|어떤 것으로 바꾸어드릴까요
어떻게|어떻게 해요
어서 오세요 손님 찾다 무엇|어서 오세요 손님 뭘 찾으세요
어제 전화를 받다 내용 말씀 드리다 아직|어제 전화 온 내용을 말씀드리지 못했어요
어쨌든 당분간 덥다 심하다 아니다 아마|어쨌든 당분간은 덜 덥겠네요
어쩔 수 없다|어쩔 수가 없었어요
없다|없어요
없다 그래서 적응 할 수 있다 걱정|없습니다 그래서 적응할 수 있을지 걱정이에요
여기 신청서 쓰다 등록비 내다 되다|여기 신청서를 쓰고 등록비를 내시면 됩니다
여기 욕실  꽤 넓다|여기가 욕실인가요? 꽤 넓군요
여자 친구 심하다 싸우다 보았다|여자 친구하고 심하게 싸우는 걸 봤어요
여자 친구 헤어지다 아마|아마도 여자 친구하고 헤어진 것 같아요
여행 가다 시간 없다|여행 갈 시간은 없어요
여행 도 아르바이트 도 겪다|여행도 하고 아르바이트도 했어요
여행 시간 많다 빼앗기다 때문 어렵다 아마|여행은 시간을 많이 빼앗겨서 어려울 것 같아요
연락 없다 늦다 어떠하다|어떻게 연락도 없이 늦을 수가 있어요
연애 결혼|연애결혼이군요
열차 오다|열차가 들어와요
영수 낚시 좋아하다 아마|영수씨는 낚시를 좋아하나 봐요
영어 공부하다 중|영어 공부를 하고 있어요
영어책 번역 일|영어책을 번역하는 일이에요
예 의사 도 담배 줄이다 말하다 끝|네 의사 선생님도 담배를 줄이라고 했어요
예식장 내빈 가득하다|예식장이 내빈으로 찼다 
옛날 중매 결혼 많다 하지만 요즘 연애 결혼 많다|옛날에는 중매결혼이 많았지만 요즘은 연애결혼이 많아요
오늘 기분 매우 좋다|오늘은 기분이 매우 좋아요
오늘 무슨 날 알다|오늘이 무슨 날인지 알아요
오늘 부터 할 수 있다|오늘부터 할 수 있어요
오늘 아침 부터 열 나다 기운없다|오늘 아침부터 열이 나고 기운이 없어요
오늘 영화 보다 못하다 같다|오늘은 영화를 보기가 틀린 것 같아요
오늘 오후 문병 가다|오늘 오후에 문병 갈까요
오늘 운 좋다|오늘은 운이 좋군요
오늘 일찍 집 들어가다 쉬다|오늘은 일찍 집에 들어가 쉬어요
오늘 중부지방 비 많다 내리다 말하다 끝|오늘 중부 지방에 비가 많이 내린다고 했어요
오늘 한글날 맞다|오늘은 한글날이잖아요
오다 시간 몇|언제까지 오실 수 있으세요
오래 기다리다 때문 미안하다|오래 기다리게 해서 미안해요
오랜만|오랜만이에요
오랫동안 사이좋다 지내다 그런데 안타깝다|오랫동안 사이좋게 지냈는데 안타까워요
올해 계획 대로 잘 지내다 있다|올해는 계획대로 잘 지내고 있어요
올해 대기업 취직 되다 좋다|올해는 대기업에 취직했으면 좋겠어요
왜|왜요
왜 무슨 일 있다|왜요 무슨 일 있어요
요리 공작 수집 어떠하다|요리 공작 수집 등은 어때요
요점 만 정확하다 답하다 좋다|요점만 정확하게 답하는 게 좋아요
요즘 많다 바쁘다|요즘 많이 바빠요
요즘 유행하다 옷 하나 사다 싶다|요즘 유행하는 옷을 한 벌 사려고요
요즘 진호 힘 없다 보이다|요즘 진호씨가 힘이 없어 보여요
요즘 피곤하다 그런데 밤 잘 자다 못하다|요즘 몸은 피곤한데 밤에 잠을 잘 자지 못해요
요즘 피곤하다 때문 학교 다니다 힘들다|요즘 피곤해서 학교에 다니는 것이 힘들어요
요즘 환절기 조심하다 되다|요즘이 환절기라 조심해야 해요
욕실 넓다 그런데 부엌 좁다|욕실은 넓은데 부엌은 좁아요
우리 여행 어떠하다|우리 여행하지 않을래요
우리 학교 한번 만나다 부탁하다|우리 학교에서 한번 만나요
우리나라 산 그리고 바다 모두 괜찮다|우리나라의 산과 바다는 모두 괜찮아요
우리나라 오다 외국인 함께 가다 어디 좋다|우리나라에 온 외국인과 어디를 가면 좋을까요
우리나라 잘 나타내다 것 좋다 같다|우리나라를 잘 나타내는 것이 좋겠죠
우선 유실물 센터 신고하다|우선 유실물센터에 신고부터 해요
우울 아직|아직도 우울해요
우편물 대신 받다 부탁하다|우편물 좀 받아 주세요
운동 영화 감상 등산 여행 아마|운동 영화 감상 등산 여행 등이겠지요
울릉도 경주 또는 가다 해보다|울릉도나 경주에 가 보세요
울릉도 특산물 많다 그리고 경주 유적 많다|울릉도는 특산물이 많고 경주는 유적이 많아요
월요일 다르다 약속 있다 안되다|월요일에는 다른 약속이 있어서 안 돼요
웨딩드레스 눈부시다|웨딩드레스가 눈부시다 
이것 검정색 원피스 어떠하다|이 검정색 원피스는 어때요
이것 집 경치 좋다|이 집은 경치가 좋네요
이것 치마 얼마|이 치마는 얼마에요
이것 헬스클럽 다니다 생각하다|이 헬스클럽에 다니려고 합니다
이번 모임 때 가다 여행지 추천하다 부탁하다|이번 모임에서 갈 여행지를 추천해 주세요
이번 방학 동안 공부 만 하다 생각하다|이번 방학 동안에는 공부만 하려고 해요
이번 연휴 낚시 가다|이번 연휴에 낚시하러 가요
이번 주 보다 일 많다 때문 걱정이다|이번 주에는 볼 일이 많아서 걱정이에요
이번 주 저 랑 등산 가다|이번 주에 저랑 산에 갑시다
이사 비용 얼마나|이사 비용은 얼마나 들까요
이사 원하다|이사를 하려고요
이사 짐 센터 묻다 되다 같다|이삿짐센터에 물어봐야 할 것 같아요
이유 한번 묻다 해보다|왜 그러는지 한 번 물어 봐요
일기 예보 말하다 무엇|일기 예보에서 뭐라고 하던가요
입다 해보다 괜찮다|입어 봐도 괜찮아요
자다 전 따뜻하다 우유 마시다 해보다 어떠하다|자기 전에 따뜻한 우유를 마셔 보는 건 어때요
자동차 가격 비싸다 아니다|자동차 가격이 비싸지 않나요
자신감 사라지다 점점|점점 자신감이 없어져요
자신감 있다 태도|자신감 있는 태도입니다
자전거 타다 괴팍하다 어떠하다|자전거를 그렇게 타면 어떻게 해요
잘 내리다 할 수 있다 걱정|잘 내릴 수 있을지 걱정이에요
잘 모르다 그냥 저 멀리하다|잘 모르겠어요 그냥 저를 멀리해요
재활용 쓰레기 어떻게|재활용 쓰레기는 어떻게 버리나요
저 가다 약속|제가 그 쪽으로 가겠습니다
저 고급 자동차 사다 계획|저는 고급 자동차를 사려고 합니다
저 다음 달 결혼하다|저도 다음 달에 결혼을 합니다
저 다음 주 출산하다|제가 다음 주에 출산을 해요
저 도 처음 무섭다 하지만 지금 제일 친하다|저도 처음엔 무서웠는데 지금은 제일 친해요
저 도 춤추다 좋아하다|저도 춤을 추는 것을 좋아해요
저 도 취미 하나 가지다 싶다|저도 취미를 하나 가지고 싶어요
저 도 하늘 맑다 가을 제일 좋다|저도 하늘이 맑은 가을이 제일 좋아요
저 도 하다 싶다 하지만 시간 없다|저도 그러고 싶지만 시간이 없어요
저 도 한국 대학교 다니다|저도 한국대학교에 다녀요
저 랑 방 쓰다 친구 때문|저랑 방을 쓰는 친구 때문이에요
저 백화점 주로 가다|저는 주로 백화점에 갑니다
저 사진 찍다 취미|저는 사진 찍는 것이 취미입니다
저 살 좀 빼다 생각하다|저는 살을 좀 빼려고 해요
저 수요일 부터 특별하다 약속 없다|저는 수요일부터 특별한 약속이 없어요
저 실수하다 같다|제가 실수를 한 것 같아요
저 알다 집 에서 민박 좋다|제가 아는 집에서 민박을 하는 것이 좋을 것 같아요
저 연필 집다 말하다|저는 연필을 집었대요
저 일주일 동안 출장 가다|제가 일주일 동안 출장 가요
저 조금 크다 아니다|저한테 좀 크지 않아요
저 조용하다 모임 찾다 중|저는 조용한 모임을 찾는 중이에요
저 지금 시험 가다 그런데 크다 일|저는 지금 시험을 보러 가야하는데 큰일이에요
저 집 젖다 수건 널다|저는 집에서 젖은 수건을 널어놓아요
저 한국 대학교 다니다 중|저는 한국대학교에 다녀요
저 함께 병원 가다 해보다|저와 함께 병원에 가 보실래요
저 휴대폰 번호 알다 주다|제 휴대폰 번호를 가르쳐 드릴게요
저기 보이다 것 남산|저기 보이는 게 남산이지요
저기 부동산 묻다 해보다|저 부동산에다 물어보세요
저기 자리 있다|저기 자리가 있어요
저녁 때 헬스클럽 다니다 해보다|저녁 때 헬스클럽에 다녀 볼까요
저희 검사 다음 적합하다 운동 알리다|저희가 검사를 해서 적합한 운동을 알려 드립니다
전공 활용 할 수 있다 일 싶다|전공을 살릴 수 있는 일을 하고 싶어요
전국 일주 계획 중 좋다 곳 추천하다 부탁하다|전국을 일주하려고 하는데 좋은 곳 좀 추천해 주세요
전기 요금 도 하숙비 포함 되다|전기 요금도 하숙비에 포함 됩니까
정리 아직 엉망|아직 정리가 덜 돼서 엉망이에요
정말|정말 그래요
정말  저희 여행 동호회 오다  해보다|정말이에요 저희 여행 동호회에 와 보세요
정말 알다 없다 사람|정말 알 수 없는 사람이에요
정말 왜|그래요 왜요
정말 잘 되다|정말 잘 되었군요
정말 축하하다|정말이요? 축하합니다
젖 먹이다 기저귀 갈다 씻기다 재우다 일|젖을 먹이고 기저귀를 갈고 씻기고 재우는 일이지요
제주도 어떠하다|제주도는 어떨까요
제주도 에서 구경하다 해보다 괜찮다 곳 어디|제주도에서 구경할 만한 곳은 어디인가요
조교 전화를 걸다 끝|조교에게 전화를 했는데요
졸리다 때문 하루 다섯 이상 마시다|졸음이 와서 하루에 5잔 이상 마셔요
좋다 건강 제일 중요하다|좋아요 건강이 제일 중요해요
좋다 낙엽이 떨어지다 산 가다|좋아요 낙엽이 떨어지는 산으로 가요
좋다 사람 소개하다|좋은 사람 소개할까요
좋다 시작하다 언제|좋아요 언제부터 시작하나요
좋다 집 이사하다 축하하다|좋은 집에 이사 온 것 축하합니다
죄송 하지만 신문 치우다 할 수 있다|죄송하지만 신문도 좀 치워 주시겠어요
죄송하다 자전거 서투르다 몸 괜찮다|죄송해요 자전거 타는 게 서툴러서요 몸은 괜찮으세요
주로 주말 공휴일 또는|주로 주말이나 공휴일에 합니다
주의 사항 무엇|주의할 사항이 뭐가 있나요?
중부 지방 대설 주의보 보도하다 끝 말하다|중부 지방에 대설 주의보가 내렸대요
지 수 얼굴 좋다 아니다 보이다|지수씨 얼굴이 안 좋아 보여요
지 수 학교 오다 아직|지수씨가 학교에 오지 않았어요
지갑 그리고 책 넣다 있다|지갑과 책이 들어 있어요
지금 기분 좋다 친구 화해하다 끝|지금은 기분이 좋습니다 친구와 화해를 했거든요
지금 표 사다 두다 고향 가다 쉽다|지금 표를 사 두어야 고향에 가기가 쉬워요
지나 물건 사다 어디|지나씨는 어디에서 물건을 사요
지불 어떻게|결재는 어떻게 하실 건가요
지하철 곳 가방 두다 내리다|지하철에 가방을 두고 내렸어요
진호 정말 미남|진호씨는 정말 미남이네요
질문 대하다 대답 어떻게|질문에 대답은 어떻게 하나요
집 구경 괜찮다|집 구경 좀 해도 될까요
집 때문 전화를 받다 학생 맞다|집 때문에 전화를 한 학생이군요
집 에서 송편 만들다 먹다 생각하다 중|집에서 송편이나 만들어 먹을까 해요
집 크다 좋다 그런데 이것 집 사다|집이 크고 좋은데 이 집을 사셨어요
집들이 선물 세제 사다|집들이 선물로 세제를 샀어요
차 문제 생기다 때문이다|자동차에 문제가 있어서 그랬어요
차 문제 생기다 출장 오다 가능하다|차에 문제가 생겼는데 출장을 나와 주시면 안 될까요
처음 오다 때문 운동 어떻게 잘 모르다|처음 와서 운동을 어떻게 하는지 잘 모르겠어요
춥다 겨울 보다 시원하다 가을 좋다|추운 겨울보다는 시원한 가을이 좋아요
취미 활동 언제|취미 활동은 언제 합니까
친절하다 가르치다 받다 감사하다|친절하게 가르쳐 주셔서 감사합니다
캐주얼 보다 정장 입다 좋다|캐주얼보다는 정장을 입는 게 좋아요
커피 줄이다 운동하다 좋다|커피를 줄이고 운동을 하는 게 좋겠어요
특별 계획 생각하다 아직|아직 특별한 계획은 생각해 보지 않았는데요
평소 아이들 많다 뛰다 같다|평소에도 아이들이 많이 뛰는 것 같아요
포기하다 말다 마지막 까지 최선 해보다|포기하지 말고 끝까지 최선을 다해 봐요
피곤 때문|피곤해서 그래요
하나 사이즈 더 크다 것 바꾸다 할 수 있다|한 사이즈 더 큰 것으로 바꿀 수 있을까요
하숙 생활하다 적 있다|하숙 생활을 해 본 적이 있나요
하지만 아직 애인 없다|하지만 아직 애인도 없어요
학교 앞에서 민박 아마|학교 앞에서 민박을 할 거예요
한글 만들다 전 사용 글자 무엇|한글이 만들어지기 전에는 무슨 글자를 사용했어요
한글 세계 자랑하다 충분하다|한글은 세계에 자랑할 만하군요
한라산 바닷가 그리고 식물원 괜찮다 말하다|한라산 바닷가 식물원 등이 괜찮다고 합니다
한복 보다 도자기 전통 인형 또는 같다|한복 보다는 도자기나 전통 인형이 좋을 것 같아요
한복 주다 도 괜찮다|한복을 주는 것도 괜찮을까요
한자 사용하다|한자를 사용했어요
할 수 있다 운동복 갈아입다 오다 부탁하다|할 수 있어요 운동복으로 갈아입고 오세요
혹시 아르바이트 해보다 마음 없다|혹시 아르바이트할 마음은 없어요
혹시 어디 아프다 아니다|혹시 어디 아픈 거 아니에요
활동적 것 좋다 아마|활동적인 것이면 좋겠어요
회사 도 냄새 때문 싫어하다|회사에서도 냄새 난다고 싫어해요
회사 사람들 저 싫어하다 같다|회사 사람들이 저를 싫어하는 것 같아요1950년 6월 25일 한국 전쟁 나다|1950년 6월 25일에 한국 전쟁이 일어났다 
30대 초반 내 집 마련하다 생각하다|30대 초반에 내 집을 마련할 생각이다 
30분 후後 도착 할 수 있다|30분 후에 도착할 수 있습니다 
가다 말 곱다 오다 말 곱다|가는 말이 고와야 오는 말이 곱다 
가능하다 면 빨리 부탁|가능한 한 빨리 해 주십시오 
강당 방학식 있다|강당에서 방학식을 한다 
거기 관심 별로 없다|거기엔 관심이 별로 없어요 
건강 위하다 금식하다|건강을 위해서 금식한다 
고기압 영향 아마|고기압의 영향을 받겠습니다 
고속철도 개통하다 끝|고속철도를 개통하였다 
공부 잘하다 때문 우등상 받다 끝|공부를 잘해서 우등상을 받았어요 
구경 가다 시간 없다|구경을 갈 시간이 없어요 
국경일 태극기 달다|국경일에는 태극기를 단다 
굽 너무 굽이 높다|굽이 너무 높아요 
그것 바지 매진되다|그 바지는 매진되었습니다 
그것 방 비어있다 아직|그 방은 아직도 비어있습니까
그 영화 벅차다 감동 받다|그 영화는 벅찬 감동을 주었다 
그녀 부끄럽다 고개를 숙이다|그녀는 부끄러워 고개를 숙이고 있다 
그녀 만나다 생각 마음 설레다|그녀를 만날 생각을 하니 마음이 설렌다 
그 대학교 졸업 후 군대 가다 계획|그는 대학교를 졸업하고 군대에 가려고 한다 
그 머리 수그리다 용서 빌다|그는 머리를 수그리고 용서를 빈다 
그 집 호화스럽다|그의 집은 호화스럽다 
그 처지 안타깝다|그의 처지가 안타깝다 
그 표정 무뚝뚝하다|그의 표정은 무뚝뚝했다 
기숙사 다 좋다 아니다 같다|기숙사라고 해서 다 좋은 건 아닌 것 같아요 
기차 서울역 출발하다 끝|기차가 서울역을 출발했다 
기차 비행기 보다 느리다|기차는 비행기보다 느리다 
기차 타다 새벽 도착하다|기차를 타고 새벽에 도착했다 
기침 나다 멍하다|기침도 나고 정신이 없어요 
나 그 화내다 후회하다|나는 그에게 화낸 것을 후회한다 
나 그 다투다 뉘우치다 있다|나는 그와 다툰 것을 뉘우치고 있다 
나 기차 타다 멀미|나는 기차만 타면 멀미한다 
나 마지막 까지 싸우다 결심하다|나는 끝까지 싸우기로 결심했다 
나 낚시 보다 축구 더 좋다|나는 낚시보다 축구가 더 좋다 
나 너 정성 감동하다|나는 너의 정성에 감동하였다 
나 매부 약속 취소하다|나는 매부와의 약속을 취소했다 
나 모두 것 귀찮다|나는 모든 것이 귀찮다 
나 무심하다 표정|나는 무심한 표정을 지었다 
나 열차 기다리다 중|나는 열차를 기다리고 있다 
나 우표 수집하다|나는 우표를 수집한다 
나 잘못 반성하다|나는 잘못을 반성한다 
나 정년 후 귀향 생각하다|나는 정년 후에 귀향할 생각이다 
나 지난 7일 동안 중국 여행하다 겪다|나는 지난 7일 동안 중국을 여행하였다 
나 만 빼다 모두 진학하다|나만 빼고 모두 진학했어요 
날씨 맑다 빨래 잘 마르다|날씨가 맑아 빨래가 잘 마른다 
날씬하다 보다 옷 좋다|날씬해 보이는 옷이 좋아요 
낯설다 사람 조심하다|낯선 사람을 조심하라 
내리다 문 오른쪽|내리실 문은 오른쪽입니다 
내일 쉬다 낫다|내일은 쉬는 게 낫겠어요 
넘어지다 발목 삐다 되다|넘어져서 발목이 삐었어요 
노란색 선 물러서다|노란색 선 뒤로 물러서세요 
노약자 보호석 앉다 안되다|노약자 보호석에 앉으면 안 돼요 
농협 에서 특산물 싸다 사다 할 수 있다|농협에서는 특산물을 값싸게 살 수 있어요 
뇌물을 받다 말다|뇌물을 받지 마라 
눈 내리다 때 우산 사용 아니하다|눈이 내릴 때에는 우산을 쓰지 않는다 
눈 변하다 비 되다|눈이 비로 변했다 
다르다 방법 없다|다른 방법이 없을까요
다르다 약속 때문 어쩔 수 없다|다른 약속이 있어서 어쩔 수 없어요 
다음 주 세일 기간|다음 주부터 세일 기간입니다 
다음 늦다 절대로|다음에는 절대로 늦지 않을게 
담배 집 밖 가다 피우다 되다|담배는 집 밖에 나가서 피워야 해요 
대기업 복지 사업 계획 발표하다 끝|대기업이 복지 사업 계획을 발표하였다 
독도 한국 땅|독도는 한국 땅이다 
동생 시무룩하다 표정 중中|동생이 시무룩한 표정을 짓고 있다 
동정 필요 없다|동정은 필요 없다 
두 사람 의견 절충하다 좋다|두 사람의 의견을 절충하는 것이 좋겠다 
마을 온통 눈 덮다 되다|마을이 온통 눈으로 덮였다 
마음 무겁다|마음이 무겁다 
매일 같다 시간 자다 일어나다|매일 같은 시간에 자고 같은 시간에 일어나요  
면접 때 화장 진하다 아니다 좋다|면접 때 화장은 진하지 않은 것이 좋다 
무슨 말씀 드리다 모르다|뭐라고 말씀드려야 할지 모르겠습니다 
바둑 장점 무엇|바둑의 장점은 무엇입니까
반드시 합격 할 수 있다|반드시 합격하고야 말겠어요 
밥 끓이다 먹이다|밥을 끓여서 먹이세요 
방값 싸다|방값이 싸다 
방 참 밝다 또 깨끗하다|방이 참 밝고 깨끗하네요 
방학 동안 하다 싶다 많다 그런데|방학 동안 하고 싶은 게 많았는데 
방학 숙제 못하다 때문 혼나다|방학 숙제를 못해서 혼났다 
방학 끝나다 면 고등학생 되다|방학이 끝나면 고등학생이 된다 
방학 때 자원 봉사 하다|방학이 되면 자원봉사를 해요 
번거롭다 만들다 죄송하다|번거롭게 해 드려서 죄송해요 
부동산 이사 집 소개 받다 곳|부동산은 이사할 집을 소개해 주는 곳이에요 
부모 잃다 아이들 가엾다|부모 잃은 아이들이 가엾다 
불고기 한번 먹다 충분하다|불고기는 한번 먹어 볼 만해요 
비 내리다 때 할아버지 더 보다 싶다|비가 내리면 할아버지가 더 보고 싶다 
비밀 지키다 부탁하다 그런데 소문 퍼지다 벌써|비밀을 지켜 달라고 부탁했는데 벌써 소문이 퍼졌다
사람들 건강 위하다 운동하다|사람들은 건강을 위해 운동을 한다 
사람들 화초 가꾸다|사람들은 화초를 가꾼다 
삼일절 독립운동 기념하다 날|삼일절은 독립운동을 기념하는 날이에요 
새해 원하다 것 성취하다 바라다|새해에는 뜻하신 바를 성취하시기 바랍니다 
생각 해보다 다시 오다 아마|생각해 보고 다시 올게요 
서로 양보하다 되다|서로 양보를 해야지요 
서울 집 사다 하늘 별 따다 같다|서울에서 집 사기는 하늘의 별 따기예요 
선생님 말씀 순종 해|선생님의 말씀에 순종하라 
선생님 인터뷰 끝|선생님하고 인터뷰를 하셨어요
설날 아침 떡국 먹다|설날 아침에는 떡국을 먹습니다 
성숙하다 사람 분노 억제 할 수 있다|성숙한 사람은 분노를 억제할 수 있다 
손자 할아버지 께 세배하다|손자가 할아버지께 세배한다 
수첩 약속 장소 기록하다|수첩에 약속 장소를 기록한다 
시험 떨어지다 할까봐 불안하다|시험에 떨어질까봐 불안하다 
식목일 쉬다 날|식목일은 쉬는 날이에요
식품 매장 가전제품 매장 이용하다|식품 매장과 가전제품 매장을 이용합니다 
신발 사이즈 얼마|신발 사이즈가 어떻게 되세요
아기 토하다 때문 소아과 데리고 가다 끝|아기가 토해서 소아과에 데리고 갔습니다 
아내 조금 섭섭하다 모양|아내는 좀 섭섭한 모양이다 
아랫사람 먼저 사과하다 옳다|아랫사람이 먼저 사과하는 것이 옳다 
아무리 결심 작심삼일|아무리 결심을 해도 작심삼일이다 
아버지 표정 우울하다|아버지의 표정이 우울하시다 
아침 일찍 운동하다|아침 일찍 운동을 합니다 
아파트 생활하다 편리하다|아파트가 생활하기 편리하다 
앞으로 잘 부탁하다|앞으로 잘 부탁드립니다 
야단맞다 할까봐 걱정|야단 맞을까봐 걱정이다 
약속 깜박 잊다|약속을 깜박 잊었다 
어제 만나다 남자 자기 이야기 만 끝없이 계속하다|어제 만난 남자는 자기 얘기만 했어요 
어제 원고 넘기다 예정이다|어제 원고를 넘길 예정이었다 
여가 시간 잘 활용|여가를 잘 활용하자 
여기 안방/묻는 표정|여기가 안방인가요
여름 때 밤 보다 낮 더 길다|여름이 되면 밤 보다 낮이 길어진다 
여학생들 음악 맞추다 체조하다|여학생들이 음악에 맞추어 체조한다 
열 내리다 설사 금방 멈추다|열이 내리면 설사는 금방 멈춥니다 
열차 역 정차하다|열차가 역에 정차한다 
오랫동안 출혈하다 면 건강 나쁘다|오랫동안 출혈하면 건강이 나빠진다 
올해 공공기관 취직 원하다|올해는 공공 기관에 취직했으면 좋겠어요 
옷 두껍다 입다 도 감기 잘 걸리다|옷을 두껍게 입어도 감기에 잘 걸려요 
외모 보다 사람 평가 안되다|외모만으로 사람을 평가하면 안 됩니다 
요즘 유행하다 디자인|요즘 유행하는 디자인이에요 
우리나라 겨울 너무 춥다|우리나라 겨울은 너무 추워요 
우리 내년 사업 계획 수정하다 끝|우리는 내년도 사업 계획을 수정했다 
우리 한번 믿다 부탁하다|우리를 한번 믿어 주세요 
음악 소리 크다 때문 집중 안되다|음악 소리가 커서 집중이 안돼요 
이것 집 짓다 오래되다 끝|이 집은 지은 지 오래되었습니다 
이것 월세|이건 월세예요 
이것 명품 핸드백|이것은 명품 핸드백입니다 
이웃 사촌 말 있다|이웃사촌이라는 말도 있잖아요 
자다 전 소금물 양치질 해보다|자기 전에 소금물로 양치질을 해 보세요 
자다 전 와인 마시다 해보다 어떠하다|자기 전에 와인을 마셔 보는 건 어때요
잘못 회개 하여라|잘못을 회개하라 
잠 불면 면 운동 해보다|잠이 안 오면 운동을 해 보세요 
재능 활용 할 수 있다 일 싶다|재능을 살릴 수 있는 일을 하고 싶어요 
저 오랫동안 선배 오해하다 같다|저는 오랫동안 선배님을 오해했던 것 같습니다 
저 요리하다 취미|저는 요리하는 것이 취미다 
저 주로 할인 매장 가다|저는 주로 할인매장에 갑니다 
저 도움을 받다 간절히 부탁하다|저를 도와주기를 간절히 부탁합니다 
전주 비빔밥 유명하다|전주는 비빔밥이 유명해요 
전화 오다 면 받다 부탁하다|전화가 오면 좀 받아 주세요 
젊은이들 산 야영하다|젊은이들이 산에서 야영한다 
제 동생 대신 사과하다|제가 동생을 대신해서 사과합니다 
제사 때 절 두 번 맞다|제사 때는 절을 두 번 하나요
중국 도 좋다 하지만 일본 가다 어떠하다|중국도 좋지만 일본에 가는 게 어때요
지금 가다 늦다 아마|지금 가 봤자 늦을 거예요 
지난 여름 때 비 잦다 내리다|지난 여름에는 비가 잦았다 
직장 생활 너무 힘들다|직장 생활이 너무 힘들어요
집 입다 해보다 작다|집에서 입어보니까 조금 작아요 
창문 열다 면 시원하다|창문을 열면 아주 시원해요 
창 밖 아름답다 호수 보이다|창밖으로 아름다운 호수가 보여요 
천둥소리 놀라다 일제히 일어서다|천둥소리에 놀라 일제히 일어섰다 
첫인상 성격 너무 다르다|첫인상과 성격이 너무 달라요 
추위 물러가다 끝|추위가 물러갔다 
추위 많다 타다 겨울 싫다|추위를 많이 타서 겨울을 싫어해요 
충분하다 수분 섭취 필요하다|충분한 수분의 섭취가 필요하다 
치통 심하다 때문 잠자다 할 수 없다|치통이 심해 잠을 잘 수가 없어요 
친구들 많다 사귀다 싶다|친구들을 많이 사귀고 싶어요 
친구 배신하다 말다|친구를 배신하지 마라 
태권도 정신 집중 도움을 받다 되다|태권도는 정신을 집중하는데 도움이 됩니다
태풍 북상 중中|태풍이 북상하고 있어요 
표 다 매진되다|표가 다 팔렸어요 
프림 대신 우유 넣다|프림 대신에 우유를 넣을래요
학비 마련하다 되다|학비를 마련해야 한다 
학생들 애국가 합창|학생들이 애국가를 합창한다 
학생 트럼프 섞다|학생이 트럼프를 섞는다 
학창 시절 꿈 무엇|학창 시절의 꿈은 무엇이었습니까
한국 사람 외국 사람 정답다 대하다|한국 사람은 외국 사람을 정답게 대한다 
한국 아시아 동쪽 있다|한국은 아시아의 동쪽에 있습니다 
한번 이기다 방심하다 안되다|한번 이겼다고 방심해서는 안 된다 
한번 만 저희 편의 도움을 받다 부탁하다|한번만 저희 편의를 봐 주십시오 
한번 실수 눈감아 주다 할 수 있다|한번의 실수는 눈감아 줄 수 있다 
할아버지 뒷산 산책하다 중|할아버지는 뒷산에서 산책하고 계신다 
화나다 미치다|화가 나서 미치겠다 
흐리다 날 우울하다 되다|흐린 날에는 우울해진다 
흥분 가라앉다|흥분이 가라앉았다 
나 어제 새롭다 옷 입다 친구 만나다|나는 어제 새 옷을 입은 친구를 만났다
너 가다 어디 물음표|너 어디가
천천히 걷다 면 도착 늦다|그렇게 천천히 걷다간 지각하겠어
아들 날 새다 면 지게 지다 가다|아들은 날새면 지게를 지고 나갔다
천천히 먹다 면 밤 새다|그렇게 천천히 먹다간 밤새겠다
공부 만 말다 가끔 쉬다|공부만 하지 말고 가끔은 쉬기도 해라
너 정말 조용하다|너야말로 조용히 해라
해 지다 면 울다 새|해곧 지면 우는 새
우리 좋다 친구 하자|우리 좋은 친구로 지내자
얌전 학생 말썽꾼 변하다|그렇게 얌전하던 학생이 말썽꾼으로 변했다
물 얼다 면 얼음 되다|물이 얼면 얼음이 된다
성공 면 연락 꼭|성공해설랑은 꼭 연락해야 한다
너 아무 걱정 말다 공부 만 열심|널랑은 아무 걱정 말고 공부만 열심히 하여라
일 걱정 말다 쉬다 충분 오다|일일랑은 걱정을 말고 푹 쉬다 와라
저것 학생 나 알다 학생 옷 모습 다르다|저 학생은 내가 알고 있던 학생과는 옷차림이 다르다
다르다 사람 상관없다 너 꼭 오다|다른 사람은 몰라도 너만은 꼭 와야 한다
형 많이 닮다|형이랑 많이 닮았구나
심심하다 영화 보다 가자|심심한데 영화나 보러 가자
느끼다 백두산 상상봉 오르다 같다|마치 백두산 상상봉에나 오른 것 같구나
집 학교 상관없다 있다 되다|집에든 학교에든 있으면 됐다
바다 또 강 걷다 기분 좋다|바닷가라든지 강가를 거닐다 보면 기분이 좋아진다
너 애들 합 놀다|너는 애들하고나 놀아라
 굿 보다 떡 먹다|굿이나 보고 떡이나 먹자
함께 혼자 상관없다 잘 놀다 되다|함께든지 혼자서든지 잘 놀면 되었지
무엇 부탁하다 면 얻다|무엇이든 구하면 얻으리라
사전 책상 위 올려놓다|사전을 책상 위에다 올려놓아라
흩어지다 시간 한 시 다시 모이다|흩어졌다가 한 실 기준으로 다시 모이자
이것 일 시작 함께 뭉치다|이 일을 시작으로 함께 뭉치자
그 일 끝나다 면 내게 오다|그 일이 끝나면 내게로 오라
그 곳 얌전 있다|그곳에설랑 얌전히 있어라
너 먼저 먹다|너부터 먼저 먹어라
바다 곳 고기 잡다|바다에설랑 고기를 잡자
회사 다니다 그만 두다 끝|회살 다니다가 그만두었다
학교 다니다 집 어렵다 때문 그만 두다|학교를 다니다가 집안 형편상 그만두었다
친구 함께 놀다 가다|친구하고 놀러 간다
나 친구 함께 영화 보다 가다|나는 친구랑 함께 영화를 보러 갔다
나 같이 놀다|나하고 놀자
푸르다 천 치마 만들다|이 푸른 천을 치마로 만들자
8일 동안 계속 이야기 문장 책 읽다|꼬박 일주일하고 하룰 소설만 읽으며 보냈어요
송편 맛있다 또 모양 예쁘다|송편이 맛뿐만 아니라 모양까지 좋구나
밥 만 먹다 말다 반찬 포함 먹다|밥만 먹지 말고 반찬도 먹어라
너도 나 떠나다|너마저 나를 떠나는구나
화장품 좋다 더해서 향 더 좋다|화장품이 품질뿐만 아니라 향기까지 좋구나
밤 늦다 또 비 내리다 때문 하루 더 자다 가다|밤도 늦었고 비까지 내리니 하루 더 묵고 가거라
책상 거기 두다|책상을 거기다가 두어라
나 잘못 조금 있다 인정하다|내가 잘못을 좀 했다손 치자
우리 가능 까지 해보다|우리가 할 수 있는 데까지 해 봅시다
오늘 까지 어렵다 면 내일 까지 괜찮다|오늘까지 어려우시면 내일까지도 괜찮습니다
비 내리다 그런데 바람 불다|비가 오는데 바람조차 부는구나
국수 먹다 해보다|국수라도 좀 먹으렴
밥 없다 면 라면 괜찮다 주다|밥이 없으면 라면이라도 주세요
고구마 먹다 해보다|고구마라도 좀 먹으렴
냄새 만 맡다 해보다 좋다 아마|냄새라도 맡아 보았으면 좋겠다
여행 가다 오다 해보다|어디 여행이라도 다녀오렴
많다 아니다 그러다 보태다 쓰다|얼마 되겠느냐마는 보태어 쓰도록 해라
아무 있다 면 나오다 해보다|아무라도 있으면 나와 보시오
너 원하다 대로|네 뜻대로 해라
밥 만 먹다 속 아프다|밥만 먹으면 속이 쓰리다
나 살다 곳 집|나의 살던 고향
다 떠나다|다들 떠나갔구나
이 책 친구 주다|이 책은 그 친굴 주어라
그대로 두다|그대로 두어라
2호선 타다 남대문 시장 가다 가능|2호선을 타면 남대문 시장에 갈 수 있나요
가능 면 담배 줄이다 부탁하다|가능하면 담배를 좀 줄이세요
가방 찾다 못하다 큰 일이다|가방을 못 찾으면 큰일인데
그것 좋다 방법|그것도 좋은 방법이군요
그래서 공부 잘하다|그래서 공부를 잘 하는구나
그래서 혼자 항상|그래서 항상 혼자 있었군요
다르다 사람 보다 다이어트 쉽다 아니다 같다|다른 사람들을 보면 다이어트는 쉽지 않은 것 같아요
담배 피다 없다 면 건강 나쁘다 없다 아마|담배를 피우지 않았더라면 건강이 나빠지지 않았을 거예요
돕다 필요하다 면 아무 때 말 부탁|도움이 필요하면 언제든지 말씀하세요
며칠 전 전화 학생|며칠 전에 전화를 걸었던 학생이에요
몸 약하다 많다|몸이 많이 약해 졌군요
미국 가다 면 어디 지내다|미국에 가면 어디에서 지내세요
병원 가다 경험|병원에는 가 봤어요
시간 흐르다 면 나아지다 아마|시간이 지나면 조금씩 나아질 거예요
안내 방송 잘 듣다 되다|안내 방송을 잘 들으면 되요
안녕하세요 무엇 일 오다|안녕하세요 무슨 일로 오셨습니까
알다 빨리 타다|알았어요 빨리 탑시다
알다 혹시 마음 바뀌다 연락 부탁하다|알겠습니다 혹시 마음이 바뀌면 연락 주세요
어제 학교 오다 중 사고 병원 가다 끝|어제 학교에 오다가 사고가 나서 병원에 갔었어요
열차 가깝다 가다 면 위험하다|열차에 가까이 가면 위험해요
영수 모습 조금 무섭다|영수씨는 조금 무섭게 생겼군요
영수증 없다 면 환불 안되다|영수증이 없으면 환불 할 수 없어요
예매하다 면 새벽 부터 줄 기다리다 필요하다|예매하려면 새벽부터 줄을 서서 기다려야 하거든요
오늘 비 내리다 전 일찍 귀가하다|오늘은 비가 내리기 전에 일찍 귀가합시다
오다 못하다 면 전화 야|못 오면 전화라도 하지 그랬어요
익숙하다 되다 면 괜찮다|익숙해지면 괜찮겠지요
비 끝다다 면 덥다 시작|장마가 끝나면 무더위가 찾아온대요
저 복권 당첨되다 원하다|저는 복권에 당첨됐으면 좋겠어요
너 정말 산 좋다|정말 산을 좋아하는군요
조금 참다 면 좋다 결과 있다 아마|조금만 참으면 좋은 결과가 있을 거예요
좋다 제주도 결정|좋아요 그럼 제주도로 결정합시다
좋다 죽 과일 사 가져가다|좋아요 죽과 과일을 사 가지고 갑시다
집 사다 면 물어보다 어디|집을 사려면 어디에 물어봐야 하나요
취업 때문 걱정 많다|취업 때문에 걱정이 많군요
친구 결혼 그렇구나|친구가 결혼을 하는군요
돈 얼마|가격은 얼마입니까
감사합니다 내일 만나다|감사합니다 내일 봐요
감사합니다 특별 돈 주다|감사합니다 여기는 팁입니다
남다 돈 또 계산서 여기 있다|거스름돈과 계산서는 여기 있습니다
밤 쉬다 잘|좋은 밤 보내세요
또 오다 부탁|또 오십시오
이것 주다 부탁|그럼 이걸로 해주세요
이 돈 아침 포함 있다 무엇 알다 원하다|이 가격은 아침을 포함하는지 좀 알고 싶습니다
길 건너편 곳 하나 있다|길 건너편에 하나 있어요
감사합니다 좋다 사람 같다|네 감사합니다 참 좋으신 분이네요
네 손님 계산서 여기 있다|네, 손님, 계산서 여기 있습니다
네 손님 즉시 예약 돕다|네, 손님, 바로 예약해 드리겠습니다
네 내일 밤 방 하나 필요하다 남다 방 있다|네  내일 밤 방이 하나 필요한데 빈 방이 있나요
네 있다 방 무엇 필요하다|네 있습니다 어떤 방이 필요합니까
네 저희 호텔 방 탈퇴 승인 시간 2시|네 저희 호텔의 체크인 시간은 오후 2시 이후입니다
내일 만나다|내일 봐요
네 포함|네 포함합니다
손님 있다 기간 예상 언제|그리고 손님은 얼마나 머물 것으로 예상하십니까
 네 하지만 할인 어제 끝 죄송합니다|네 하지만 할인은 이미 어제 끝났습니다 죄송합니다
돕다 무엇|무엇을 도와드릴까요
미안하다 하지만 좋다 먹다 곳 추천 부탁|실례합니다 좋은 식당 좀 추천해주실래요
돈 계산 부탁|계산해주세요
매우 가깝다|아주 가까워요
알다 비싸다 없다 무엇|알겠어요 그럼 좀 덜 비싼 건 없나요
음식 무엇 먹다 원하다|어떤 음식을 드시고 싶으세요
없다 그것 가장 싸다 방|없습니다 그것은 가장 싼 스위트룸입니다
여기 있다|여기 있습니다
멀다|여기서 멀어요
가깝다 곳 한국 먹다 곳 있다|이 근처에 한국 식당이 있습니까
저 바다 보다 가능 방 좋다|저는 바다를 볼수 있는 방을 좋아합니다
좀 비싸다|좀 비싸네요
저 호텔 곳 할인 있다 듣다 끝|저는 호텔에서 할인을 해주고 있다고 들었는데요
최고 여기 곳 음식 먹다 곳 어디|최고의 로컬 푸드는 어디에서 먹을 수 있습니까
하루 자다 돈 250 달러|하룻밤에 250 달러입니다
3일 정도|한 3일 정도
호텔 가다 공항 버스 타다 어디|호텔로 가는 공항버스는 어디서 탑니까
걷다 시간 얼마|걸어서 얼마나 걸립니까
경찰서 어디|경찰서가 어디예요
계산 잘못 아마 이 돈 무엇|계산이 잘못 된 것 같아요 이 금액은 뭐예요
계산 하다|계산하겠습니다 
화장실 어디|공중화장실은 어디에 있습니까
관광 안내 책자 하나 주다 부탁|관광 안내 책자 하나 주세요 
관광 안내 곳 어디|관광 안내소가 어디입니까
뉴욕 곳 가장 유명하다 무엇|뉴욕에서 가장 유명한 것은 무엇입니까
다르다 물건 보다 주다|다른 것 좀 보여 주십시오 
다르다 방 바꾸다 부탁|다른 방으로 변경해 주십시오 
더 작다 치수 바꾸다 원하다|더 작은 치수로 바꾸고 싶습니다 
도난 신고 원하다|도난 신고를 하고 싶습니다 
도난 신고서 주다|도난 신고서를 발행해 주세요 
문구점 층 어디|문구점은 몇 층입니까
방 매우 춥다|방이 너무 춥습니다 
배 아프다|배가 아픕니다 
변기 고장|변기가 고장 났습니다 
분실물 센터 곳 어디|분실물 센터는 어디인가요
분실물 취급소 어디|분실물 취급소는 어디에 있어요
비싸다|비싸네요 
사고 신고서 주다|사고 신고서를 주세요 
선물 포장 부탁|선물 포장을 해 주십시오 
수건 더 주다 가능|수건을 더 줄 수 있을까요
시내 가다 택시 타다 어디|시내로 들어가는 택시는 어디서 타나요
시장 가다 출구 번호 무엇|시장으로 가려면 몇 번 출구로 나가야 하나요
시청 가다 버스 타다 어디|시청 가는 버스는 어디에서 타나요
시청 목적 표 두개 주다|시청행 두 장 주십시오 
신용 카드 가능|신용 카드로 계산해도 되나요
미안하다 하지만 이것 길 지하철역 도착 가능|실례지만, 지하철역까지 이 길로 가면 됩니까
찾다 계속 없다|아무리 찾아도 없습니다 
아침 먹다 언제|아침 식사는 언제 할 수 있습니까
어디 두다 잊다|어디에 두었는지 잊어버렸습니다 
어린이 의자 미리 준비|어린이 의자를 준비해 주십시오 
어제 점심 먹다 이후 부터|어제 점심 먹은 이후부터요 
기다리다 언제까지|얼마나 기다려야 합니까
여기 주문 부탁|여기 주문 받아 주십시오
여기 아프다|여기가 아픕니다 
여기 지도 곳 어디|여기가 이 지도에서 어디입니까
예약 원하다|예약을 하고 싶습니다
오늘 밤 시간 여섯 시 세 사람 자리 예약 원하다|오늘 밤 여섯 시에 세 사람 자리를 예약하고 싶습니다
왕복|왕복이에요 
가깝다 곳 전자 제품 매장 어디|이 근처에 전자 제품 매장이 있습니까
여기 가장 인기 메뉴 무엇|이 집에서 가장 인기 있는 메뉴는 뭐예요
이거 입다 괜찮다|이거 입어 봐도 됩니까
얼마|이건 얼마예요
이거 교환 원하다|이걸 교환하고 싶습니다 
이것 약 같다 무엇|이것과 같은 약 주세요 
입장료 얼마|입장료는 얼마입니까
저것 보다 주다|저것 좀 보여 주십시오 
저쪽 테이블 옮기다 가능|저쪽 테이블로 옮길 수 있을 까요
제 방 청구 부탁|제 방을 청소해 주십시오 
제 지갑 소매치기|제 지갑을 소매치기 당했습니다 
제 짐 사라지다|제 짐이 없어졌습니다 
제 짐 파손|제 짐이 파손됐습니다
둘러보다 괜찮다|좀 둘러봐도 될까요
이따가 주문|좀 있다가 주문하겠습니다 
중앙 박물관 내리다 어디|중앙 박물관에 가려면 어디서 내려야 하나요
지금 한국 대사관 연락 부탁|지금 한국 대사관으로 연락해 주세요 
진료 원하다 오다|진료 받으러 왔습니다 
진통제 주다|진통제 좀 주십시오 
짐 맡기다 가능|짐을 맡아줄 수 있을까요
창가 자리 부탁|창가 자리로 부탁합니다 
방 탈퇴 승인 원하다|체크아웃하고 싶습니다
방 확인 승인 원하다|체크인하고 싶습니다 
하루 자다 돈 얼마|하룻밤 가격이 얼마인가요
한 사람 당 얼마|한 사람당 얼마예요
화장품 팔다 곳 찾다|화장품 코너를 찾고 있습니다
환불 부탁|환불해 주시겠어요
1500달러 있다|1,500달러를 갖고 있습니다
10달러|10달러입니다
1218호|1218호입니다
12번 출구 가다 길 알리다 부탁|12번 출구로 가는 길을 일러주시겠습니까
1999년 10월|1999년 10월 입니다
2일 있다|2일간 머물려고 합니다
2주 있다|2주 정도요
2주|2주일입니다
4시 30분 차 있다|4시 30분 차 있습니까
5시 40분 무엇|5시 40 분은 어떻습니까
5월 7일 토요일 비행기 취소 부탁|5월 7일 토요일 비행기를 취소해 주십시오
7월 8일 날 NW023|7월 8일자 NW023입니다
7월 12일 날 같은 비행기 예매 부탁|7월12일 자, 같은 비행기편으로 해주세요
7월 23일 2003편 예약 변경 원하다|7월23일 2003편의 예약을 변경하고 싶습니다
커피 달라|Coffee로 주세요
성 무엇|First name이 무엇입니까
홀리데이 인 입니다 돕다 무엇|Holiday Inn입니다 무엇을 도와 드릴까요
LA 목적 비행기 표 주다 부탁|LA까지 편도표를 주세요
가깝다 병원 인도 돕다 부탁|가까운 병원까지 데려다 주세요
가능 면 빨리 진찰 원하다|가능하면 빨리 진찰을 받고 싶군요
가슴 아프다 숨 쉬다 어렵다|가슴이 아픕니다 숨쉬기가 어렵습니다
감사합니다 조심하다 가다|감사합니다 안녕히 계십시오
거기 곳 까지 택시 타다 시간 얼마|거기까지 택시로 얼마나 걸립니까
걷다 시간 10분 정도|걸어서 10분쯤 걸립니다
계산서 여기 있다|계산서가 여기 있습니다
고맙습니다 나 들다|고맙습니다 제가 그냥 들을게요
공항 까지 가다|공항까지 갑시다
과일 야채 있다|과일이나 야채 같은 것을 갖고 있나요
관광차 오다|관광차 왔어요
교환 돕다 무엇|교환입니다 무엇을 도와 드릴까요
기침 심하다 기침 시작 계속 멈추다 못하다|기침이 심해서 한번 기침을 하면 멈출 수가 없습니다
매우 아프다 병원 까지 인도 부탁|너무 아파요병원까지 데려다 주세요
네 넣다 부탁|네, 넣어주세요
네 돕다 무엇|네, 뭘 도와드릴까요
노스웨스트 항공사 입니다 말 부탁|노스웨스트 항공사입니다 말씀하세요
돕다 무엇|무엇을 도와드릴까요
뉴욕 출발 LA 도착 시간 얼마|뉴욕에서 LA까지 얼마입니까
뉴욕 출발 LA 가다 표 예약 원하다|뉴욕에서 LA로 가는 표를 예약하고 싶습니다
다르다 사람 전달 부탁 물건 있다|다른 사람이 전해달라고 부탁한 물건이 있습니다
다리 부러지다|다리가 부러졌습니다
다음 정류장 내리다 부탁|다음 정류장에서 내려 주세요
담배 한 보루 있다 나 피우다 목적 사다|담배 한 보루인데요 제가 피우려고 샀습니다
담배 피우다 가능 방 원하다|담배를 피우는 방을 원합니까
담요 주다 부탁|담요를 좀 주시겠습니까
담요 주다 부탁|담요를 주시겠습니까
당신 이름 무엇|당신 이름이 무엇입니까
도난 신고 원하다|도난 신고를 하려고요
두통 때 좋다 무엇|두통에는 뭐가 좋습니까
두통 심하다|두통이 심합니다
마이애미 도착 비행기 있다|마이애미까지 가는 비행기편이 있습니까
며칠 비행기 원하다 무엇|며칠 자, 어느 비행기로 하시겠습니까
모든 보험 가입|모든 보험에 가입하겠습니다
목 아프다 편도선 있다|목이 아픕니다 편도선이 있습니다
목 아프다|목이 아픕니다
보험 가입 무엇|무슨 보험에 가입하시겠습니까
일 무엇|무슨 일입니까
물 한 컵 부탁|물 한 컵 주시겠어요
물고기 알레르기 있다|물고기 알레르기가 있습니다
도난 무엇|뭘 도난 당하셨죠
마시다 무엇|뭘 마시겠습니까
미국 있다 기간 얼마|미국에서 얼마나 계실 건가요
미안합니다 저 여기 곳 처음 똑같다|미안합니다 저도 여기는 처음입니다
미안합니다 하지만 없다|미안합니다만 없는데요
발 삐었다|발을 삐었습니다
방 번호 무엇|방 번호가 어떻게 됩니까
방 열쇠 잊어버리다|방 열쇠를 잊어 버렸습니다
방문 목적 무엇|방문 목적이 뭐죠
방 열쇠 두고 나오다|방에 열쇠를 두고 나왔습니다
버스 정류장 어디|버스 정류장이 어딥니까
베개 주다 부탁|베개를 주시겠습니까
보스톤 목적 버스 예약 원하다|보스톤 가는 버스를 예약하고 싶은데요
보스톤 목적 자리 예약 원하다|보스톤 가는 좌석을 예약하고 싶은데요
보스톤 목적 열사 타다 곳 맞다 무엇|보스톤 행 열차의 홈이 맞습니까
보통 자리 부탁|보통석으로 부탁합니다
복통 있다|복통이 있습니다
분실물 신고 무엇|분실물 신고계가 어디죠
비행기 번호 무엇|비행기 번호가 어떻게 됩니까
LA 곳 비행기 도착 시간 언제|비행기가 LA에 몇 시에 도착하게 됩니까
사업 목적 오다|사업차 왔어요
사진 포함 신분증 보다 주다 부탁|사진이 있는 신분증을 보여주시겠습니까
설탕 크림 넣다 무엇|설탕과 크림은 넣을까요
성함 무엇|성함이 무엇입니까
세금 포함 돈|세금을 포함한 가격입니까
소형 또 대형차 있다 무엇|소형 또는 대형차가 있습니까
소화제 사다 원하다|소화제를 사고 싶습니다
숙소 어디|숙소는 어디입니까
스테이크 부탁|스테이크로 주세요
돼지고기 부탁|식사로 돼지고기를 주세요
신고 있다 무엇|신고 하실 것 있습니까
신용카드 가지다 있다 무엇|신용 카드를 가지고 있습니까
신용 카드 또 운전 면허 가지다 무엇|신용 카드와 운전 면허가 있습니까
미안합니다 자리 변경 가능 무엇|실례합니다 저하고 지리를 좀 바꿀 수 있을 수 있을까요
미안합니다 길 잃다|실례합니다 제가 길을 잃었는데요
미안합니다 시티은행 가다 길 알다 부탁|실례합니다만 시티은행 가는 길을 좀 알려 주세요
아니요 그냥 구경 중|아니오, 그냥 둘러보는 중입니다
아니요|아니오
아닙니다 신용카드 가지다 있다|아닙니다, 신용 카드가 있습니까
안녕하세요 달라스 목적 가다|안녕하세요 달라스로 가나요
안녕하세요 자다 깨우다 목적 전화 입니다|안녕하십니까 Morning call입니다
안녕하세요 방 예약 끝|안녕하십니까? 방을 예약해 두었습니다
안정제 부탁|안정제를 주세요
걷다 시간 약 한 시간 정도 멀다|약 한시간 정도라서 걷기에는 좀 멀지요
약국 곳 어디|약국이 어디죠
어디 곳 도착 돕다|어디로 모실까요
보스톤 목적 버스 타다 곳 어디|어디서 보스톤 가는 버스를 탈수 있습니까
허드슨가 곳 도착 버스 무엇|어떤 버스가 허드슨가에서 섭니까
어지럽다|어지럽습니다
방 승인 확인 언제|언제 Check in하실 겁니까
멀다 얼마나|얼마나 멉니까
빌리다 오래 얼마|얼마나 오랫동안 빌릴 겁니까
돈 얼마|얼마를 소지하고 계십니까
돈 얼마|얼마입니까
없다|없습니다
여권 발견 가능 있다 무엇|여권을 찾을 가능성이 있습니까
여기 곳 내리다 부탁|여기 세워 주세요
여기 있다|여기 있습니다
여기 있다 남다 돈 필요 없다|여기 있습니다거스름 돈은 필요 없습니다
열 있다|열이 있습니다
옆구리 아프다|옆구리가 아픕니다
네 2명 자다 가능 방 있다 무엇|예, 2명이 자는 방이 있습니까
네 비자 카드 있다|예, Visa 카드를 가지고 있습니다
네 맞다|예, 그렇습니다
네 받다 하다|예, 받겠습니다
네 여기 사인 부탁 감사합니다|예, 여기에 사인해 주십시오 감사합니다
네 있다|예, 있습니다
예약 확인 끝|예약 확인되었습니다
예약 번호 알리다 부탁|예약번호를 알려주시겠습니까
예약 가능|예약을 할 수 있습니까
예약 아직 하지만 매우 급하다|예약이 되어 있지는 않은데요, 너무 급합니다
예약 다시 확인 무엇|예약재확인을 해야 하나요
오늘 방 승인 확인 원하다|오늘 Check in 하려고 합니다
오렌지 주스 부탁|오렌지 쥬스로 주세요
오른손 움직이다 못하다|오른손을 움직일 수가 없습니다
오른쪽 배 아프다|오른쪽 배가 아픕니다
온 몸 가리다|온몸에 가렸습니다
온 몸 발진 생기다|온몸에 발진이 있습니다
옷 가방 사라지다|옷 가방을 도난 당했습니다
왕복 표 얼마|왕복표는 얼마죠
워싱턴 도착 돈 얼마|워싱턴까지 얼마입니까
유효 만료일 언제|유효 만료일이 언제입니까
음료수 원하다 무엇|음료수는 뭐로 하시겠습니까
음료수 주다 부탁|음료수를 좀 주시겠습니까
이 거리 이름 무엇|이 거리의 이름이 뭐죠
가깝다 곳 약국 어디|이 근처에 약국이 어디에 있습니까
이 길 계속 걷다 두번째 코너 곳 좌측 곳 걷다|이 길을 따라가서, 두 번째 코너에서 좌측으로 걸어가세요
양식 작성 부탁|이 양식을 작성해 주시겠습니까
옷 입다 괜찮다 무엇|이 옷을 입어봐도 되겠습니까
이 주소 곳 가다 부탁|이 주소로 가 주세요
돈 얼마|이것은 얼마입니까
사다 원하다|이것을 사겠습니다
이 열차 보스톤 목적 맞다 무엇|이게 보스톤행 열차입니까
이름 박 성 HK|이름이 Park이고 First name이 HK입니다
이름 무엇|이름이 무엇입니까
이 짐 당신 직접 준비 무엇|이짐을 당신이 직접 쌌습니까
호텔 도착|자, 호텔에 도착 했습니다
잠깐|잠깐만요
잡지 또 읽다 책 주다 부탁|잡지나 읽을 거리를 좀 주시겠어요
저 버스 힐튼 호텔 가다 무엇|저 버스가 힐튼 호텔에 갑니까
저기 까지 걷다 얼마|저기까지 걸어서 얼마나 걸리까요
저 노트북 PC 찾다 중|저는 노트북 PC를 찾고 있습니다
저기 곳 가다 왼쪽 돌아가다|저리로 똑바로 가서 왼쪽으로 돌아가세요
전화 번호 알리다 주다|전화 번호를 불러 주세요
저 있다 곳 지도 곳 어디 확인 부탁|제가 지금 어디에 있는지 이 지도상에서 알수 있나요
저 짐 들다 돕다 무엇|제가 짐을 들어 드릴까요
좋습니다 7시 깨우다 돕다|좋습니다 7시에 깨워 드리겠습니다
좋습니다 하루 돈 얼마|좋습니다 하루 요금이 얼마입니까
죄송합니다 자리 바꾸다 가능|죄송합니다 자리를 좀 바꿀 수 있을까요
벌써 자리 가득|벌써 자리가 다 찼군요
도둑 아마 지갑 사라지다|주머니가 털린 것 같아요 지갑이 없어요
주소 알리다 부탁|주소를 알려주십시오
중형차 있다 무엇|중형차는 있습니까
지갑 사라지다|지갑이 없어졌어요
진찰 원하다|진찰을 받고 싶습니다
진통제 주다 부탁|진통제를 주시겠어요
짐 수 몇|짐이 몇 개 입니까
치통 있다|치통이 있습니다
너무 아프다 참다 어렵다|너무 아파 견딜 수가 없습니다
침대 두 개 있다 방 원하다|침대가 두개 있는 방을 원합니다
돈 얼마|요금이 얼마입니까
카드 번호 부탁|카드 번호를 불러 주시겠습니까
탑승권 여기 있다|탑승권이 여기 있습니다
택시 타다 곳 어디|택시 타는 곳이 어디죠
편도 얼마|편도는 얼마죠
하나|하나입니다
하루 돈 얼마|하루 요금이 얼마 입니까
하루 30달러 일주일 150 달러|하루에 30달러이며 일주일에 150 달러입니다
하복통 있다|하복통이 있습니다
허드슨가 내리다 부탁|허드슨가에서 내려 주세요
현금 또 여행자 수표 지불 원하다|현금/여행자 수표로 지불하고 싶습니다
계산 현금|현금으로 계산하겠습니까
계산 신용카드|신용 카드로 계산하겠습니까
호텔 앞 지갑 도난|호텔 앞에서 지갑을 도난 당했습니다
담배 가지다 있다 무엇|혹시 담배 같은 것은 갖고 계십니까
혼자 자다 방 원하다 무엇|혼자 자는 방을 원하십니까
후두통 심하다|후두통이 심합니다
힐튼 호텔 도착 부탁|힐튼 호텔까지 부탁합니다
힐튼 호텔 도착 얼마|힐튼 호텔까지 얼마입니까
힐튼 호텔 가다 방법 알리다 부탁|힐튼 호텔에 가는 방법을 알려 주시겠습니까
14일 비행기 예약 원하다|14일 비행기로 예약하고 싶습니다
699번지|669번지입니다
LA 곳 힐튼 호텔|LA의 힐튼 호텔입니다아무것 때 상관없다 나 알리다 달라다|어떠한 경우라도 반드시 내게 알려주세요
어떠한 사람 운전 함부로|어떤 사람들은 제멋대로 운전을 하지요
일 무엇|어떤 업종에 종사하십니까
그 말 조금 맞다|어떤 의미로는 그가 옳아요
음악 좋다 무엇|어떤 종류의 음악을 좋아하나요
매우 감사|어떻게 감사를 드려야 할지 모르겠군요
결정 아무것 좋다|어떻게 결정하셔도 저는 좋아요
고치다 방법 아무것 모르다|어떻게 고치는지 전혀 모르겠는데요
생각 어떻게|어떻게 그런 생각을 해냈죠
건강 어떻게|어떻게 그렇게 건강하십니까
영어 잘하다 어떻게|어떻게 그렇게 영어를 잘하십니까
부르다 무엇|어떻게 부를까요
좋다 방법 무엇|어떻게 뾰족한 수가 없을까요
생각 무엇|어떻게 생각하세요
여행 방법 무엇|어떻게 여행하실 건가요
살다 잘하다 무엇|어떻게 지냈어요
어렵다 결정|어려운 결심을 하셨군요
상황 어렵다 때 오다|어려울 때는 저한테 오세요
말 안되다|어림도 없는 소리
어머|어머
어머니 말 듣다 끝|어머니 말씀 들었지
둘 어울리다|어울리는 한 쌍이군요 
어제 여기 곳 토스터 샀다 하지만 고장|어제 이 토스터를 이곳에서 샀는데 고장이네요
당신 지식 사용 없다 왜|어째서 당신의 지식을 활용하지 않지요
감사합니다|어쨌든 감사합니다
매우 날씬|어쩜 그렇게 날씬하세요
그 돌아오다 언제|언제 그가 돌아올 건가요
언제 하다|언제 그것을 해 놓을까요
오다 언제|언제 들어오시죠
가다 언제|언제 떠나십니까
끝 언제|언제 막이 오릅니까
새 집 이사 언제|언제 새집으로 이사해요
패션쇼 언제 어디 곳 열리다|언제 어디서 그 팬션쇼가 열립니까
중계 언제|언제 중계됩니까
분만 예상 언제|언제가 분만 예정일인가요
나중에 당신 이 일 후회 오다 아마|언젠가 당신은 이 일을 후회하실 거예요
얼굴 매우 익숙|얼굴이 굉장히 낯이 익은데요
얼마 동안 사업 부진 하지만 지금 보다 앞으로 희망 아마|얼마 동안은 사업이 부진했지만 지금은 전망이 좋아 보입니다
감사하다 매우|얼마나 감사한지 모르겠어요
도착 언제|얼마나 더 가야 돼죠
수영 거리 얼마|얼마나 멀리 수영할 수 있나요
오다 시간 얼마|얼마나 오래 걸렸습니까
시간 오래 얼마|얼마나 오래 걸릴 것 같습니까
끝 언제|얼마나 있으면 끝날까요
아무것 좋다|얼마든지 좋아요
돈 얼마|얼마입니까
얼마 전 밤 때 당신 티비 나오다 보다|얼마전 밤에 당신을 텔레비젼에서 봤어요
없다 보다 낫다|없는 것 보다는 낫지요
엎치락 뒤치락 잠 불면|엎치락뒤치락하다 한 잠도 못 잤습니다
엘리베이터 타다 이층 내리다 왼쪽 꺾다|엘리베이터를 타고 2층으로 올라가서 왼쪽으로 돌아 가세요
에스컬레이터 찾다 중|에스컬레이터를 찾고 있는 중입니다
엘리베이터 내리다 우측 가다|엘리베이터에서 내리셔서 우측으로 가십시오
쉬다 때 무엇|여가에는 무엇을 하나요
여기 아프다|여기가 아파요
여기 있다|여기 있습니다
여기 몇 층|여기가 몇 층입니까
여기 어디|여기가 어딥니까
여기 마지막 곳|여기가 종점입니다
다르다 질문 있다 무엇|여기까지 다른 질문은 없습니까
여기 무엇 때문 문제|여기는 대체 뭐가 문제라서 그런 거예요
여기 직접 기름 넣다 곳 질문|여기는 본인이 직접 기름을 넣는 곳인가요
여기 곳 거리 얼마|여기서 거리가 얼마나 되지요
여기 곳 담배 괜찮다 질문|여기서 담배를 피워도 될까요
여기 곳  당신 만나다 기대 없다|여기서 당신을 보리라곤 기대하지 않았습니다
여기 곳 박물관 멀다 얼마|여기서 박물관까지는 얼마나 멉니까
여기 곳 우체국 가다 방법 무엇|여기서 우체국을 어떻게 갑니까
여기 주차 못하다 표지 못 보다|여기에 주차할 수 없다는 팻말은 보지 못했는데요
관심 살피다 받다 매우 감사|여러모로 고려해 주셔서 정말 고맙게 생각 합니다
여유 주다 그들 더 주다 아마|여유를 주면 줄수록 그들은 더 달라고 할 거예요
지금까지 어디 곳|여태 어디 있었습니까
역 가다 길 알리다 주다|역으로 가는 길 좀 가르쳐 시겠어요
연극 때 맡다 역할 무엇|연극할 때 맡은 역이 뭐죠
공부 열심 좋다|열심히 공부하는 게 나쁠 건 하나도 없어요
공부 열심 없다 면 합격 어렵다|열심히 공부하지 않으면 영어에서 합격점을 따기 어려울걸요
열 있다|열이 있으세요
영수증 가져가다|영수증을 가지고 계세요
영어 발전 시간 충분|영어를 향상시킬 시간은 충분히 있어요
영어 훌륭|영어를 훌륭하게 구사하시는 군요
영어 시험 점수 100점|영어시험에서 100점을 받았습니다
영화 시작 아직3|영화가 시작될 때가 되지 않았어요
옆 집 살다 사람 충고|옆집에 사는 사람이 충고를 해 주더군요
갑자기 발생 일 때문 늦다|예기치 않았던 일로 늦었다
갑자기 발생 일 때문 어제 저녁 전화 못하다|예기치 않았던 일이 생겨서 어제 저녁에 전화를 못 드렸습니다
예약 자리 질문|예약석인가요
예전 당신 만나다 경험 있다 아마|예전에 당신을 어디선가 뵌 것 같습니다
오랜만|오래간만입니다.
오늘 기분 무엇|오늘 기분은 어때
오늘 기분 안좋다 보다|오늘 기분이 언잖아 보이는데
오늘 날씨 무엇|오늘 날씨가 어떻습니까
오늘 전화 3번째|오늘 세번째 전화 거신건데요
오늘 아침 교통 매우 복잡|오늘 아침에 교통이 굉장히 복잡했어요
오늘 오후 몸 좀 이상하다|오늘 오후에 몸이 좀 이상하군요
오늘 오후 약속 가능|오늘 오후에 약속을 할 수 있을까요
오늘 오후 야구 경기 중요 있다|오늘 오후에 중요한 야구경기가 있다던데요
오늘 우울 왜|오늘 왜 그렇게 시무룩하니
우리 오늘 정원 일 끝|오늘 우리 정원일을 끝냅시다
오늘 끝 필요없다|오늘 이걸 끝낼 필요는 없습니다
오늘 저녁 때 시간 1시간 가능|오늘 저녁에 한 시간 좀 내어 주시겠어요
저 오늘 정신 없다|오늘 제가 제 정신이 아니군요
오늘 특별 요리 무엇|오늘 특별요리가 뭐죠
오늘 밤 쇼 보다 가다 안하다|오늘밤 쇼를 보러 가지 않겠어요
지금 끝|오늘은 이만 합시다
오늘 무엇|오늘은 좀 어떠세요
오늘 이 곳 일하다 처음 때문 나 안내 돕다|오늘이 이곳에서 일하는 첫날이나 제가 안내를 좀 해드리지요
오래 질문|오래 걸립니까
오래 기다리다 미안|오래 기다리게 해서 미안합니다
오래 전부터 만나다 원하다|오래 전부터 한번 찾아뵙고 싶었습니다
오케스트라 공연 함께 가다|오케스트라 공연에 저와 함께 가시겠습니까
오해 하지마|오해하지는 마세요
오히려 나 기쁘다|오히려 제가 기쁩니다
올라가다|올라갑니다
옷 모습 보다 취미 고상 아마|옷을 입으신 것을 보니 취미가 고상하시군요
왜|왜 그러세요
왜 신발 새롭다 사다 안하다|왜 새 신발을 사지 않으세요
안되다 왜|왜 안 된다는 거죠
왜 한눈팔다|왜 한눈 팔고 있어
요금 얼마|요금은 얼마나 될까요
요령 배우다|요령을 배웠어요
요리 기술 훌륭|요리 솜씨가 훌륭하시군요
요즘 경기 잘하다|요즘 경기가 좋은 모양이군요
요즘 살다 무엇|요즘 어떻게 지냅니까
용돈 공제|용돈에서 공제해 버려요
우리 TV 나오다 못하다|우리 TV가 잘 안나와요
우리 계획 결정 아직|우리 계획은 아직 미정입니다
교대|우리 교대로 해요
우리 번갈아가다 좋다 아마|우리 돌아가는 것이 좋지 않을까요
우리 부엌 싱크 막히다|우리 부엌 싱크가 막혔습니다
어디 가다 커피 마시다 대화|우리 어디 가서 커피라도 한잔 하면서 얘기 좀 할까요
제비 뽑다 해보다|우리 제비 뽑기로 합시다
우리 좋다 친구 원하다|우리 좋은 친구가 되었으면 합니다
우리 프로그램 매일 아침 방송|우리 프로그램이 매일 아침 방송됩니다
우리 2대 5 지다|우리는 2대 5로 패배했어요
우리 같다 운명|우리는 같은 운명이예요
우리 저번에 그 곳 정말 재미있다|우리는 그 곳에서 정말 재미있었어요
우리 그 문제 대해 말 싸우다 끝|우리는 그 문제에 대해서 한바탕 입씨름을 벌였어요
우리 그것 암기 필요|우리는 그것을 암기하지 않으면 안 되었어요
우리 그 일 때문 다투다 하지만 이후 화해|우리는 그일로 다투었으나 곧 화해했어요
우리 무슨 일 있다 알다|우리는 무슨 일이 있었는지 알고 있어요
우리 전세 버스 가다|우리는 전세 버스로 갔습니다
우리 중 가장 예쁘다 누구|우리들 중 누가 더 예쁘다고 생각하세요
우리 믿다|우리를 믿으세요
우리 집 변기 물 내리다 안되다|우리집 변기가 물이 잘 내려가지 않아요
마지막 까지 싸우다 계속|우린 끝까지 싸울 겁니다
우리 여러 번 당신 이야기 경험|우린 여러 번 당신 이야길 했었지요
우리 벌써 끝|우린 이미 끝이 났어
함께 우산 괜찮다 무엇|우산 좀 같이 쓸 수 있습니까
우체국 지나다 있다|우체국을 지나서 있습니다
우체국 찾다 중|우체국을 찾고 있어요
운전 면허증 보다 달라다|운전 면허증을 좀 보여주시겠어요
움직이다 하지마|움직이지 마라
지금 통화 중|지금 통화중입니다.
지금 곳 어디|위치가 어디쯤 됩니까
유실물 센터 신고 좋다 아마|유실물센터에 신고하는 게 좋겠어요
음식 맛 무엇|음식 맛이 어떻습니까
음식 차갑다 또 돕다 엉터리 값 어이없다|음식도 차고 서비스는 엉망이고 값은 터무니없었거든요
음식 더 먹다 무엇|음식을 좀 더 드시겠어요
의견 말 달라다|의견을 말씀해 주세요
의미 통하다|의미가 통합니까
의사 만나다 검사 해보다|의사한테 가서 진찰을 받아 보시지요
의심 이유 없다|의심할 여지가 없어요
가방 어떻게|이 가방을 어떻게 할까요
강 수영 도착 가능|이 강을 수영해서 건너갈 수 있습니다
이 구역 3 곳 팻말 있다|이 구역에는 팻말이 세 군데 붙어 있습니다
그림 진짜 구별 어렵다|이 그림이 진본인지를 구별하기가 힘들군요
근처 곳 기념 물건 팔다 곳 있다 무엇|이 근처에 기념품 판매점이 있나요
근처 곳 백화점 있다 모르다|이 근처에 백화점이 있는지 모르겠네요
근처 곳 주유소 잇다|이 근처에 주유소가 있습니까
기계 조작 방법 가르치다 달라다|이 기계의 조작법을 좀 가르쳐 주세요
넥타이 돈 얼마|이 넥타이는 얼마입니까
맥주|이 맥주가 김이 빠졌군요
나 이 문제 때문 곤란하다|이 문제로 나는 곤경에 처해 있어요
이 방 곳 담배 괜찮다|이 방에서 담배를 피워도 괜찮아요
버스 가다 목적 곳 어디|이 버스는 어느 방향으로 가는 버스죠
버스 타다 도착 곳 어디|이 버스를 타면 그 곳까지 가는 겁니까
이 번호 항상 연락 가능|이 번호로 항상 연락이 되나요
빵 오래 딱딱|이 빵이 오래되어 딱딱해요
이 사진 나오다 잘하다|이 사진에 아주 잘 나왔네요
이 서류 기입 부탁|이 서류에 기입 좀 해 주시겠어요
이 소포 비행기 보내다 원하다|이 소포를 비행기편으로 부치고 싶습니다
음악 듣다 못하다|이 음악을 도저히 못듣겠어
자리 없다|이 자리 비어 있습니까
이 주소 곳 가다 방법 가장 좋다 무엇|이 주소로 가려는데 어떻게 가야 가장 좋겠어요
이 책 나 생각 영향|이 책은 내 사고방식에 영향을 주었습니다
이 책 읽다 이해 가능 무엇|이 책을 이해할 수 있나 한번 읽어 보세요
크림 상하다|이 크림이 상했군요
이 타이 당신 옷 안 어울리다|이 타이는 당신 옷에 어울리지 않네요
편지 가지다 잘|이 편지를 잘 간수하세요
이 표 오늘 만 사용 가능|이 표는 당일만 유효합니다
이것 공식 아니다|이건 비공식입니다
이것 잘못 조금 있다 아마|이건 어딘가 잘못되어 있는 것 같지 않아요
이것 무엇|이건 어떻습니까
이것 나 학과 어렵다|이건 제게 어려운 학과 였어요
청산|이걸로 청산된 것으로 합시다
이것 사다|이것도 사겠습니다
이것 돕다 잘 알다 가능|이것으로 잘 알 수 있어요
이것 결함 있다|이것은 결함이 있는 것 같아요
이것 확실 이야기 가능|이것은 내가 장담할 수 있는 사실입니다
이것 길 막히다|이것은 막다른 길입니다
이것 비밀|이것은 아주 비밀입니다
이것 켜다 방법 무엇|이것은 어떻게 켜는 겁니까
이것 비밀 조용|이것은 절대로 비밀입니다
이것 보다 잠깐|이것을 잠깐 보십시오
이것 가지다 잠깐 부탁|이것을 좀 들고 있어 주시겠어요
이것 보다 부탁|이것을 한번 훑어봐 주시겠습니까
이것 괜찮다 생각|이것이 괜찮다고 생각하실 줄로 알고 있습니다만
이것 단연 최고|이것이 단연 최고급입니다
이것 진짜 무엇|이게 정말 그렇까요
이 곳 일 매우 즐기다 깨닫다 아마|이곳에서 일하는 것이 매우 즐겁다는 것을 알게 될거예요
이기다 아마|이길 수도 있지요
이 나라 있다 기간 얼마|이나라에 얼마동안 머물 예정이십니까
이따금 당신 변덕 있다|이따금 당신은 꽤 변덕인 것 같아요
안되다|이러시면 안 되는 데요
지금 날씨 비슷 좋다 무엇|이런 날씨 좋아하세요
지금 상황 대해 조언 필요|이런 상황에 대하여 조언이 필요합니다
이 방식 표현 괜찮다 무엇|이런 식으로 표현하는 것이 어떨까요
훌륭하다 가구 가져오다 어떻게|이렇게 훌륭한 가구를 어디서 구했나요
이름 만들다 끝 무엇|이름은 지으셨나요
이름 떠오르다 없다|이름이 갑자기 생각이 안 나는군요
일주일 사용 가능 아마|이만하면 1주일은 쓰겠어요
괜찮다 아마 무엇|이만하면 괜찮아 보입니까
오래 사용 가능 아마|이만하면 당분간은 쓰겠어요
안내 받다 끝|이미 안내를 받고 있어요
이번 일요일 함께 가다 무엇|이번 일요일에 함께 갈까요
이번 공부 기간 때 공부 신청 얼마|이번 학기에는 몇 과목이나 수강신청을 했습니까
이번 하다 누구|이번에 누구 차례지요
이 분 박수 크다 부탁|이분께 큰 박수를 부탁드립니다
이 분 밖 곳 인도 부탁|이분을 밖으로 안내하시요
이제 공부 시작 필요|이제 공부를 좀 해야 할 것 같아요
이제 욕 그만|이제 그 욕 좀 그만 하시죠
그만|이제 그만 합시다
이제 시작|이제 막 시작했을 뿐입니다
방금 한국 서울 곳 전화 잘못|이제 방금 한국 서울로 건 전화는 잘못걸린 전화였습니다
싸우다 그만|이제 싸움을 그만 합지요
알다|이제 알겠어요
잊다 괜찮다|이제 잊으셔도 됩니다
출발 괜찮다 무엇|이제 출발할 수 있나요
괜찮다|이젠 괜찮습니다
이쪽 오다|이쪽으로 오세요
이 편지 한국 보내다 돈 얼마|이편지를 한국으로 보내는 데 얼마 듭니까
이해 가능|이해할 만하네요
인기 매우|인기가 대단하시겠어요
인생 다 똑같다|인생은 다 그런거예요
일인 방 있다 무엇|일인실이 있습니까
시간 7시까지 회의 끝|일곱 시 까지는 회의를 끝냅시다
날씨 나쁘다 때문 회의 취소|일기가 나빠 그 회의는 취소되었습니다
오늘 밤 날씨 무엇|일기예보는 오늘 밤이 어떨 거라고 합니까
방법 배우다 이후 어렵다 없다|일단 요령만 익히면 어렵지 않아요
말 되다|일리가 있는 말이군요
일부러 필요 없다|일부러 그러실 것은 없습니다
일부러 하지마|일부러 그런 짓은 하지 마세요
일부러 일어나다 필요없다|일부러 일어나실 것까지는 없어요
일 순조롭다 중|일은 좀 순조롭게 진행되어 가나요
비슷하다|일종의 그런 거죠
일주일 동안 다르다 도시 가다 있다|일주일 동안 다른 도시에 가 있어요
일찍 일어나다|일찍 일어나라
일찍 자다 일찍 일어나다 좋다|일찍 자고 일찍 일어나는 게 좋아요
입장 돈 얼마|입장료가 얼마입니까
입장 바꾸다 생각 해보다|입장을 바꿔 놓고 생각해 보세요
회원 들어가다 돈 얼마|입회비는 얼마입니까
있다 이야기 말 중요|있는 그대로 말하는 게 중요해요
있다 그대로 자연 행동|있는 그대로 자연스럽게 하세요
잊다|잊어버리세요
잊다 하지마 기억 부탁|잊지 말고 기억하세요
자동차 번호 무엇|자동차 번호가 어떻게 되나요
자동차 조심 부탁|자동차를 조심하세요
자리 있다 무엇 살피다|자리에 계신지 알아보겠습니다
자리 앉다 부탁|자리에 앉아 주십시오
자신감 위해 더 연습 필요|자신감을 갖기 위해선 정말 더 연습해야 되겠어요
자신 책망 하지마|자신을 책망하지 마세요
자신감 이야기 못하다|자신있게 얘기할 수 없어요
어린이 자전거 조심|자전거 타는 아이들에 주의하세요
자존심 버리다 부탁|자존심을 버리세요
작곡 경험 있다|작곡해 본 적 있어요
작년 스키 타다 어디 곳|작년엔 어디로 스키타러 갔나요
거스름돈 가지다|잔돈은 가지세요
잘하다 모르다|잘 모르겠네요
잘 생각 해보다 대답 부탁|잘 생각하시고 대답하세요
오다 잘하다|잘 왔다
지적 잘하다|잘 지적해 주셨어요
기다리다 잠깐|잠깐 기다리세요
잠깐 동안 쉬다 이후 다시 시작|잠깐 동안 쉬도록 합시다
잠깐 만나다 원하다|잠깐 만나 뵙고 싶습니다
잠깐 쉬다|잠깐 쉽시다
잠깐 시간 기회 달라다|잠깐 시간좀 내 주시겠어요
잠깐 대화 가능 질문|잠깐 이야기 좀 할 수 있을까요
잠깐 나 대신 부탁|잠깐 제 대신 좀 해 주시겠어요
잠깐 만나다 가능 질문|잠깐 좀 볼 수 있을까요
잠깐 기다리다|잠깐만 기다리세요
잠깐 쉬다 커피 마시다|잠시 손을 놓고 커피를 드세요
잠깐 나 집중 부탁|잠시 제게 주목해 주십시오
잠깐 이야기|잠시 한 말 하겠어요
자다 잘하다|잠을 아주 푹 잘 잤습니다
방해 때문 가다 못하다|장애물 때문에 지나갈 수가 없었어요
저기 기와 집 보다 있다 질문|저 기와집이 보입니까
저 사람 나 차 박다 뻔|저 사람 내차를 거의 받을 뻔했어요
저 사람 달리다 잘하다|저 사람 참 잘 달리는 군요
저 소년 앞으로 훌륭 아마|저 소년은 언젠가 반드시 훌륭해질 거예요
저 여자 연주 노래 무엇|저 여자가 연주하고 있는 곡이 뭐죠
저 여자 화면 나오다 잘|저 여자는 화면이 꽤 잘 받는 편이군요
저 여자 그대로 똑같다|저 여자분이 하시는 걸로 하겠습니다
저 외투 마음 들다|저 외투가 맘에 드는데요
저 컴퓨터 가지다 원하다|저 컴퓨터를 정말로 갖고 싶어요
저기 상자 달라다 부탁|저기 있는 저 상자 좀 집어 주시지 않겠습니까
저녁 시간 정말 즐기다|저녁시간 정말 즐거웠습니다
나 10분 이후 도착|저는 10분 후면 그 곳에 도착할 거예요
나 그 의심|저는 그가 의심스럽습니다
나 영어 복습 필요|저는 영어를 복습해야 합니다
나 오늘 몸 좋다 아니다|저는 오늘 몸이 좋질 않습니다
나 이 곳 낯설다|저는 이 동네에 생소해요
나 일 많다|저는 일에 많이 시달리고 있어요
나 노력 많다 해보다|저는 최선을 다해 한번 해 볼 겁니다
나 한 번 보다 사람 기억 꼭|저는 한번 본 사람은 꼭 기억합니다
나 거기 가다 중|저도 거기에 가는 길입니다
나 생각 똑같다|저도 그렇게 생각했습니다
나 당신 똑같다 모르다|저도 모르기는 당신과 마찬가지입니다
나 바보|저도 참 바보 같았어요
나 어쩔 수 없다|저로서는 어쩔 수 없군요
나 해결 어렵다 문제 있다|저로선 해결하기 힘든 문제가 하나 있습니다
나 돕다 가능 모르다|저를 도와 주실 수 있나 모르겠네요
나 방해 없다|저에게 전혀 방해되지 않아요
나 함께 가다 질문|저와 함께 가실래요
나 함께 사진 부탁|저와 함께 사진을 찍어 주시겠어요
나 아버지 돕다 때문 성공 가능|저의 성공은 아버지 덕분이죠
나 형 기타 배우다 2년 동안|저의 형은 2년간 기타 수업을 받았어요
나 돕다 부탁|저좀 도와 주시겠어요
저희 함께 가다 가능 모르다|저희와 함께 가실 수 있는지 모르겠네요
저희 함께 감사하다|저희와 함께 시간을 보내 주셔서 감사합니다
나 상관 없다|전 상관 없어요
나 정말 모르다|전 정말 모르겠어요
전부 말 아마|전부 말했을 거야
전부 처음부터 필요 아마|전부 처음부터 다시 해야할 것 같아요
전 만나다 경험 아마|전에 만난 적이 있는 것 같은데요
전하다 말 있다 무엇|전하실 말씀이 있습니까
전하다 말 종이 적다 부탁|전할 말씀을 종이에 써 주시겠어요
아무것 모르다|전혀 모르겠어요
전화번호 다시 말 부탁|전화번호를 다시한번 말씀해 주세요
전화 있다|전화온 것 있어요
절대 말 안하다 맹세|절대 입 밖에 내지 않기로 맹세할께요
점심 나 사다|점심은 내가 사죠
정말 가다 원하다|정말 가고 싶어요
정말 감사하다|정말 감사합니다
정말 인내 어렵다|정말 견디기 어려운 것이다
그 정말 수영 잘하다|정말 그는 수영을 잘하네요
정말|정말 그렇다구요
정말 멋있다|정말 근사한데요
정말 모르다|정말 모르겠는데요
정말 잘하다|정말 잘했어요
정말|정말이야
정신 병|정신 나갔어요
나 가방 지키다 부탁|제 가방 좀 봐 주시겠어요
나 걱정 하지마|제 걱정은 마세요
나 옆 있다 부탁|제 곁에 있어주세요
나 말 믿다 못해 차 주인 연락 해보다|제 말을 믿지 못하겠거든 차 주인에게 연락해 보세요
나 말 이해 가능 질문|제 말을 이해 하시겠어요
나 부탁 있다|제 부탁 하나 들어 주시겠습니까
나 소개|제 소개를 드리겠습니다
나 영어 공부 돕다 감사하다|제 영어 공부를 도와 주셔서 고맙습니다
나 이야기 잘 듣다 부탁|제 이야기를 끝까지 들어 주세요
나 자리 지키다 부탁|제 자리 좀 봐 주시겠어요
나 차 방금 고장|제 차가 막 고장이 났어요
나 가다 가지다 오다|제가 가서 가져올께요
나 주유소 어디 곳 찾다 해보다|제가 주유소가 어디 있는지 살펴 보죠
나 돕다 무엇|제가 도와 드릴 일이라도 있나요
나 돕다 무엇|제가 도와 드릴까요
나 도착 시간 언제|제가 몇시에 거기로 갈까요
나 인도 돕다|제가 모시고 가죠
나 몸 감기|제가 몸살이 났습니다
나 잘못 실수 정말 사과|제가 범한 과실에 대해 진실로 사과합니다
나 잘못 실수 대신 사과 원하다|제가 범한 실수에 대해 제가 사과드리고 싶습니다
나 보다 아이디어 훌륭|제가 보기에 그 아이디어는 아주 훌륭해요
나 손해 배상|제가 손해를 배상해 드리겠습니다
나 손해 보상|제가 손해를 보상해 드리겠습니다
나 싫다 결국 무엇|제가 싫다고 하면 어떻게 되는 거죠
나 안내 돕다 무엇|제가 안내를 해 드릴까요
나 안내 돕다|제가 안내해 드리죠
나 약속|제가 약속할께요 
나 여기 곳 일하다 시간 9개월 정도|제가 여기서 일한 지 아홉달이 됐습니다
나 예 해보다|제가 예를 하나 들어 보겠습니다
나 오히려 감사하다|제가 오히려 고맙죠
나 포함 괜찮다 무엇|제가 좀 끼어도 될까요
나 차 집 도착 돕다 가능|제가 차로 댁까지 모셔다 드릴수 있어요
나 말 취소|제가 한 말 취소하겠어요
먹다 조금|조금 더 드세요
참다 조금|조금만 참으시죠
조심 부탁|조심하세요
조언 부탁|조언 좀 부탁합니다
조금 기다리다 이후 간단 먹다 원하다 질문|조금 기다렸다가 디저트를 드시겠습니까
돕다 부탁|좀 도와 주시겠어요
조금 생각|좀 생각해 보지요
더 자세하다 이야기 부탁|좀더 자세히 보세요
더 크다 이야기 부탁|좀더 크게 말씀해 주시겠어요
더 힘 내다 부탁|좀더 힘내세요
종업원 약 200명 정도|종업원이 약 200명쯤 됩니다
좋다|좋습니다
좋다 원하다 그대로 부탁|좋으실 대로 하십시오
생각 좋다|좋은 생각입니다
좋다 방법 있다|좋은 수가 있어요
좋다 식당 알다 무엇|좋은 식당을 알고 계십니까
좋다 원하다 그대로|좋을대로 하세요
좌석 바꾸다 가능 무엇|좌석 좀 바꿀 수 있겠습니까
좌석 매진|좌석이 매진되었습니다
좌석 결정 무엇|좌석이 정해져 있는 겁니까
죄송하다 하지만 9시 약속 있다|죄송하지만 아홉시에 약속이 있는데요
죄송하다|죄송합니다
주소 가르치다 달라다|주소좀 가르쳐 주시겠어요
조심 필요|주의하는 것이 좋겠어요
주차 잘못|주차를 잘못 하셨습니다
줄 부탁|줄을 서세요
지금 가다 중|지금 가는 중이예요
지금 날씨 무엇|지금 기온이 어떻게 돼요
지금 오다 부탁|지금 들어오시겠습니까
지금 매우 급하다 일 중|지금 몹시 급한 일에 매여 계신데요
지금 생각 무엇|지금 무슨 생각하고 있는 거죠
지금 하다 무엇|지금 뭘 하고 있어요
지금 영화 무엇|지금 상영되는 영화는 무엇인가요
지금 시작 좋다 아마|지금 시작하는 것이 좋을 것입니다
지금 까지 그냥 살다|지금까지는 그럭저럭 지냈어요
지도 찾다 해보다|지도에서 찾아보시지 그래요
근처 곳 지하철 있다 무엇|지하철 역이 이 근처에 있습니까
지하철 곳 가다 길 가르치다 달라다 부탁|지하철역으로 가는 길 좀 가르쳐 주세요
일 무엇|직업이 무엇인가요
일 때문 미치다|직장 때문에 미칠 지경입니다
일 늦다 미안하다|직장에 늦어서 미안합니다
차분 부탁|진정하세요
질문 괜찮다 무엇|질문을 해도 되나요
짐 들다 사람 돕다 있다|짐꾼이 가방을 운반해 드릴 겁니다
집 도착 돕다 부탁|집까지 태워다 주시겠어요
차 타다 돕다 부탁|차 좀 태워 주시겠어요
차 깨끗 씻다 필요|차를 좀 씻어야겠군요
차갑다 물 달라다 부탁|찬물 한 컵 주시겠습니까
정말 멋있다|참 멋지군요
정말 잘하다|참 잘한다
창문 열다 괜찮다 무엇|창문을 열어도 괜찮겠어요
책임 사람 누구|책임자가 누구입니까
처음 만나다|처음 뵙겠습니다
천정 물 새다|천정에 물이새요
취미 무엇|취미가 뭡니까
친절|친절도 하시네요
커피 마시다 원하다 무엇|커피 한잔 드시겠습니까
커피 마시다 대화|커피를 들면서 얘기해요
코 막히다|코가 막혔다
돕다 크다|큰 도움이 되었어요
크다 빌딩 보다 가능 무엇|큰 빌딩이 보입니까
타다 표 보다 달라다 부탁|탑승권을 좀 보여 주시겠습니까
차 돕다 감사하다|태워다 주셔서 감사합니다
택시 타다 시간 얼마|택시를 타면 얼마나 걸립니까
솔직하다 이야기 해보다|털어놓고 얘기합시다
토요일 때 상점 시간 언제|토요일은 상점시간이 어떻게 됩니까
편하다 원하다 그대로|편하신대로 하세요
편하다 앉다 부탁|편히 앉으세요
평일 때 시간 6시까지 주말 때 시간 5시 까지 열다|평일에는 6시까지이고 주말에는 5시까지 엽니다
표 사다 못하다 아마|표를 못 살 것 같은데요
필요 없다 빼다 낫다 아마|필요 없는 것은 빼 놓는게 좋겠어요
지금 일 보류 구경 가다 부탁|하던일을 잠시 놓고 어서 가서 구경 좀 하세요
말 이야기 무엇|하려는 말이 뭐죠
하루 24시간 계속|하루 24시간 엽니다
크다 일 발생하다 뻔|하마터면 큰일 날 뻔 했군요
안하다 낫다 아마|하지 않는 것이 좋을 것 같아요
약 하나 먹다|한번에 한 알씩만 복용하십시오
일 혼자 일하다 힘들다|한사람이 하기엔 일이 너무 벅차요
잠 불면|한잠도 못잤어요
말 있다|할 얘기가 좀 있습니다
가능 아마|해낼 수 있겠어요
형편 없다|형편없었습니다
그 여자 누구 알다 혹시|혹시 그 여자가 누군지 아세요
그 살다 곳 어디 알다 혹시|혹시 그가 어디에 사시는지 아십니까
혼동|혼동하셨어요
화 하지마|화를 내지 마세요
화요일 만나다 가능 질문|화요일에 만날 수 있을까요
화장실 사용 가능 질문|화장실 좀 써도 되겠어요
화장실 어디|화장실이 어디입니까
대화 내용 바꾸다 하지마|화제를 바꾸지 마세요
화해 원하다|화해합시다
확인 부탁|확인 좀 해 주세요
환대 감사|환대에 감사드립니다
이야기 흥미 있다|흥미있는 얘기입니다
따뜻하다 바람 안되다|히터가 안들어 온다코로나19 감염 막다 여행 안전 위하다 미리 준비 물건|코로나19 대비 안전 여행 기본 준비물
여행 사람|여행자
마스크(여분 포함), 손 소독제, 개인 물통|: 마스크(여분 포함), 손 소독제, 개인 물통 등
어뮤즈트래블|어뮤즈트래블
마스크, 손 소독제(일 사람 전용, 손님 전용), 머리 온도 검사 기계(일 사람 전용, 손님 전용),|마스크, 손 소독제(직원용, 고객용), 체온계(직원용, 고객용), 
독하다 약 뿌리다 또 병 막다 관리 물건|소독·방역 용품 등
코로나19 상황 거리 두기 법|코로나19 속 거리두기 수칙
몸 아프다 때 3~4일 집 안 있다|아프면 3~4일 집에 머물기
다르다 사람 거리 2M 이상|사람과 사람 사이 두 팔 간격 건강 거리 두기
30초 이상 손 씻다|30초 손 씻기
기침 팔 들다 입 가리다|기침은 옷소매로 가리기
하루 2번 이상 공기 환기|매일 2번 이상 환기
시간 결정 독하다 약 뿌리다|주기적 소독
사람 만나다 못하다 하지만 마음 친밀|거리는 멀어도 마음은 가까이
손 씻다 방법|손 씻기 방법
손바닥 손바닥 마주대다 문지르다.|손바닥과 손바닥을 마주대고 문질러 줍니다.
손바닥 손바닥 마주잡다 문지르다.|손가락을 마주잡고 문질러 줍니다.
손등 손바닥 마주잡다 문지르다.|손등과 손바닥을 마주대고 문질러 줍니다.
손바닥 엄지 손가락 잡다 돌리다 문지르다.|엄지 손가락을 다른편 손바닥으로 돌려가며 문질러 줍니다.
손가락 마주잡다 손깍지 끼다 문지르다.|손가락을 마주대고 손깍지를 끼어 문질러 줍니다.
손바닥 엄지 손가락 잡다 돌리다 문지르다.|엄지 손가락을 다른편 손바닥으로 돌려가며 문질러 줍니다.
여행 중 코로나19 병 발생 때|여행 중 코로나19 증상 발현 시
여행 사람|여행자
머리 뜨겁다 또 기침 목 아프다 즉시 집 가다|발열 및 호흡기 증상(기침, 인후통 등)이 나타나면 여행을 중단하고 즉시 귀가한다.
3~4일 정도 집 쉬다 또 몸 상태 살피다|3~4일 정도 자가 격리하며 충분한 휴식을 취하고 경과를 지켜본다.
다르다 사람 만나다 안되다 또 집 가족 가깝다 다가가다 조심 필요하다|주변 사람과 만나는 것을 최대한 자제하고, 집안에서 가족과의 접촉 또한 최소화한다.
병 검사 또 휴식 이후 몸 병 낫다 다시 생활 시작 가능 하지만 몸 아프다 계속 보건소 또 1339,|진료 및 휴식 후 증상이 없어지면 일상으로 복귀하고, 증상이 심해지면 관할 보건소 또는 1339, 
지역번호 120번 전화 물어보다 말 그대로 행동하다|지역번호+120으로 전화 문의 후 안내를 따른다.
어뮤즈트래블|어뮤즈트래블
일 사람 열 37.5 이상 또 기침, 목 아프다 있다 즉시 일 중단 집 돌아가다|직원이 37.5도 이상의 발열 또는 호흡기 증상(기침, 인후통 등)을 보이면 해당 직원을 바로 퇴근 조치한다.
회사 안 곳 코로나19 감염 상황 관련하다 가깝다 보건소 또 1339 전화 물어보다 말 그대로 행동하다|사업장 내 코로나19 확진 상황에 대해서는 관할 보건소 또는 1339에 문의한 후 안내를 따른다.
여행 사람|여행자
항상 마스크|마스크 상시 착용
활동 이전 이후 물 흐르다 손 씻다 30초 이상|활동 전 후, 흐르는 물에 비누로 30초 이상 손 씻기
손 소독제 (문, 사람 많다 곳 또 다른 사람 함께 물건 사용 때, 필수)|손 소독제 사용 (출입문, 공용 시설 및 기구 접촉 시, 필수)
독하다 약 뿌리다 또 병 막다 관리 목적 제안 순종 (머리 뜨겁다, 기침 목 아프다 있다 없다 확인, 신분증 확인)|소독 및 방역에 협조 (발열 및 호흡기 증상 여부, 신원 확인 등)
다르다 사람 거리 2M 이상 (자리 선택 때, 다른 곳 가다 때, 기다리다 때)|타인과 두 팔 간격 건강 거리 유지 (좌석 선택 시, 이동 중, 대기 시)
공기 환기 없다 곳 또 사람 많다 곳 조심|밀폐된 공간이나 밀집 지역에 가급적 가지 않기
다르다 사람 함께 사용 화장실 또 사람 많다 곳 가다 하지마|공용 화장실 등 공용 구역 및 시설에 오래 머물지 않기
다르다 사람 악수 포옹 하지마|타인과 악수나 포옹 등 신체 접촉하지 않기
수건 또 수저 필요 있다 개인 가져가다|필요 시, 수건, 수저 등 개인용품 지참하기
표 사다 때 미리 인터넷 표 예약 또 자동 표 사다, 직접 표 사다 기계 사용|매표 시, 온라인 사전 예매 및 자동 매표기, 무인 키오스크 이용하기
다르다 사람 현금, 카드 상품 주다 받다 때 손 씻다 또 손 소독제 사용|타인과 현금, 카드, 상품 주고받을 때, 손 씻거나 손 소독제 사용하기
물건 사다 때 가능 만약 핸드폰 결제 방식 사용하다 (모바일 페이, OR코NFC 카드 등)|계산 시, 가급적 전자 결제 방식 이용하기 (모바일 페이, QR코드, NFC카드 등)
손 씻다 아직 때 눈, 코, 입 만지다 하지마|씻지 않은 손으로 눈, 코, 입 만지지 않기
머리 뜨겁다 또 기침 목 아프다 사람 모두 만나다 하지마|발열, 호흡기 증상이 있는 사람과의 접촉 피하기
집 돌아가다 즉시 목욕 또 그날 입다 옷 빨다|귀가 후, 목욕 및 외출복 세탁하기
어뮤즈트래블|어뮤즈트래블
병 막다 관리 책임 사람 뽑다 또 일 곳 상황 맞추다 병 막다 관리 법 만들다|방역 관리자 지정 및 사업자 유형에 맞는 집단 방역 지침 수립
일 사람 모두 마스크 꼭 일 가다 때 또 일 때 머리 뜨겁다 또 기침 목 아프다 있다 즉시 집 보내다|전 직원 마스크 착용 출근 시, 근무 중 발열 체크 및 증상 확인 의심 증상 보이는 직원 즉시 퇴근 조치
실내 안 곳 시간 결정 독하다 약 뿌리다 일 사람 사용 곳 포함|실내 공간 수시 소독 (직원 전용 공간 포함)
방 안 곳 시간 결정 공기 환기 일 사람 있다 곳 포함|매일 2회 이상 환기 (에어컨 사용 시기에도 철저하게 적용)
문 앞 안 곳 손 소독제 두다|출입구 및 시설 곳곳에 손 소독제 비치
일 사람 손님 많다 만나다 때 위생 장갑 계속 바꾸다 또 손 소독제 사용|이용객 접촉이 많은 직원은 매 접촉 시, 위생 장갑을 교체하거나 손 소독제 사용
코로나 막다 관련하다 책 두다 또 작성|방역 일지 비치 및 작성
손님 거리 2M 이상 필요 설명 또 사람 수 제한|이용자 간 두 팔 간격 건강 거리 유지할 수 있도록 수시로 안내하고 입장 인원 제한하기
병 막다 관리 또 독하다 약 뿌리다 있다 상황, 머리 뜨겁다,기침 콧물 사람 방문 못하다 미리 알려주다|방역 및 소독 상황, 유증상자 입장 제한사항 등은 사전 안내
이동 수단|이동 수단
대중교통(전용 벤&전세 버스)|대중교통 (전용 벤&전세 버스)
손잡이 시간 결정 독하다 약 뿌리다 또 정기적 병 막다 관리|손잡이 등 수시 소독 및 정기적인 방역 실시
차 운전 시작 이전 이후 공기 환기 계속|운행 전후 수시로 환기하기
차 에어컨 있다 차 멈추다 때 공기 환기 (고속도로 휴게소, 정류장 등)|차량 내 에어컨 사용 시 정차 중 환기(고속 도로 휴게소, 정류장 등)
차 또 배 타다 목소리 크다 이야기 하지마|차량 및 선박 내에서 큰 소리로 안내하지 않기
일 사람 서로 대화 하지마|직원 간 불필요한 대화 자제
상황 필요 때 차, 배 운행 수 줄이다 또 타다 사람 제한|필요 시 운행 횟수 감축 및 탑승 인원 제한
손 소독제 또 마스크 여분 두다|손 소독제 및 여분의 마스크 항시 준비
시간 결정 문 손잡이 독하다 약 뿌리다|문 손잡이 등 수시 소독
고속 도로 휴게소|고속 도로 휴게소
직접 주문 기계 있다 때 사용 가능 알려주다|무인 주문 기계가 있을 경우, 비대면 주문 유도
테이블 또 의자 거리 2m 이상|두 팔 간격 떨어진 테이블 및 좌석 배치
실내 전시 및 체험|실내 전시 및 체험
실내 전시 (박물관, 미술관, 전시관 등)|실내 전시(박물관, 미술관, 전시관 등)
시간 결정 독하다 약 뿌리다 또 공기 환기 계속|수시로 소독하고 자주 환기하기
사람 가득 안되다 구역 시간 언제 사람 몇 명 제한 미리 결정|관람객이 한꺼번에 몰리지 않도록 구역 및 시간대 별 관람 인원 제한 및 동선 관리
병 감염 위험 곳 병 막다 관리 계속|감염 위험이 있는 공용 시설 철저 관리
기념 물건 사다 곳 카페 곳 시간 결정 독하다 약 뿌리다 또 병 막다 관리|기념품점, 카페 등 수시 소독 및 관리
체험 (공예, 요리, 악기 체험 등)|체험 (공예, 요리, 악기 체험 등)
체험 곳 시간 결정 독하다 약 뿌리다 또 공기 환기 계속|체험 공간 수시 소독 및 상시 환기
체험 시작 이전 이후 물건 독하다 약 뿌리다 닦다 또 관리|체험 운영 전후 체험 도구 소독 및 관리
사람 많다 안되다 미리 예약 신청 방식 사용|예약제로 체험객이 몰리지 않도록 조정
체험 사람 사용 테이블 의자 거리 멀다, 투명 칸막이 설치|체험객 테이블이나 좌석 간격 조정, 투명 칸막이 등 설치
체험 사람 사용 목적 위생 장갑 손 소독제 또 휴지통 뚜껑 덮다 두다|체험객용 위생장갑, 손 소독제 및 뚜껑 있는 쓰레기통 비치
실외 구경 여행 곳 또 활동 놀다|실외 관광지 및 액티비티
실외 구경 여행 곳(명승지, 한옥 마을 등)|실외  관광지(명승지, 한옥 마을 등)
화장실 또 다르다 사람 함께 사용 곳 독하다 약 뿌리다 또 병 막다 관리 방법|화장실 등 공용 시설 소독 및 방역 절차
손님 퍼지다 목적 미리 사람 많다 시간 언제 알려주다|이용객 혼잡 시간대 공지로 분산 이용 유도
사람 많다 곳 2m 이상 거리 표시|사람이 몰리는 곳에 두 팔 간격 이상으로 위치 표시하기
활동 놀다 (짚라인, 루지, 패러글라이번지 점프 등)|액티비티 (집라인, 루지, 패러글라이딩, 번지 점프 등)
안전 장비 또 다르다 사람 함께 사용 물건 시간 결정 독하다 약 뿌리다|안전 장비 및 공용 용품 수시 소독
사람 걷다 곳 포함 방 안 밖 모두 독하다 약 뿌리다|체험객 이동 동선 포함 실내외 전 시설 소독
체험 끝 이후 헬멧 또 안전 보호 목적 물건 즉시 독하다 약 뿌리다|체험 후, 헬멧 등 안전 장비 및 체험 기구 즉시 소독
식당|식당
독하다 약 뿌리다 공기 환기 또 청소 깨끗 식당 선택|소독, 환기 등 위생 수칙을 잘 지키는 식당 선정
사람 많다 혼란 안되다 미리 예약|다른 이용자들과 혼잡스럽지 않게 미리 예약하기
테이블 거리 멀다 조정|테이블 간격 여유 있게 조정
커피숍|커피숍
주문 기다리다 때 거리 2M 이상 안내|주문하거나 대기할 때 두 팔 간격 건강 거리 유지하도록 안내
테이블 거리 멀다 조정|테이블 간격 여유 있게 조정
다르다 사람 함께 사용 컵, 포크, 접시, 쟁반 독하다 약 뿌리다 또 깨끗 관리|여러 사람이 사용하는 머그 컵, 포크, 접시, 쟁반 등 소독 및 위생 관리
자다 곳|숙박 시설
호텔, 콘도 자다 곳|호텔, 콘도 등 숙박 시설
자다 곳 독하다 약 뿌리다, 공기 환기 또 청소 깨끗 찾다 선택|소독, 환기 등 위생 수칙을 잘 지키는 숙박 업소 선정
여행 사람 들어가다 때 손 소독제 사용|여행객 출입 시, 손 소독제 사용
방 승인 확인 때 머리 뜨겁다 또 기침 목 아프다 있다 없다 확인|체크인 할 때, 발열 체크 및 호흡기 증상 확인
방 탈퇴 확인 이후 방 안 청소 때 즉시 독하다 약 뿌리다|체크아웃 후, 객실 청소 시 바로 소독
자다 사람 걷는다 길 독하다 약 뿌리다 (주차장, 안내데스크, 엘리베이터, 복도, 객실)|투숙객 이동 동선 따라 중점 소독 (주차장, 안내데스크, 엘리베이터, 복도, 객실)
사우나, 수영장 사용 사람 수 제한, 병 막다 관리 계속|사우나, 수영장 등 시설 출입 인원 통제, 방역 및 관리 철저
캠핑 곳|캠핑장
독하다 약 뿌리다, 공기 환기 청소 깨끗 캠핑 곳 찾다 결정|소독, 환기 등 위생 수칙을 잘 지키는 캠핑장 선정
텐트 설치 때 거리 2m 이상|텐트 설치 간격 넓히기 (최소 2미터 이상)
텐트 안 적당하다 사람 수 제한|텐트 내에 적정 인원수 배치하기
물건 사는 곳, 설거지 곳, 화장실, 샤워 곳 다르다 사람 함께 사용 곳 시간 결정 독하다 약 뿌리다 또 관리|매점, 개수대, 화장실, 샤워장 등 공용 시설 수시 소독 및 점검
지역 정보|지역 정보
모두 여행 경험 글|모두 여행기
여행 사진 구경|여행 사진전
모두 매거진|모두 매거진
출입 곳 정보|출입국 정보
출입 곳 공항 정보|출입국 공항 정보
우리 나라 국내 공항 곳 부터 국제 공항까지|우리나라 국내 공항에서 국제공항까지!
공항 곳 여행 처음 시작! 공항 대해 궁금 많다?|여행의 첫 시작을 함께하는 공항! 공항에 대해 궁금한 게 많으시다구요?
때문 준비 국제 공항 또 국내 공항 입국 출국 정보 또 실시간 운항 정보|그래서 준비했습니다. 국제공항과 국내 공항 입,출국 정보와 실시간 운항 정보까지!
최신 공항 정보 찾다 가능|가장 최신의 공항 정보를 만나보세요.
국제 공항 또 여객 터미널 소개 또 출입국 설명|국제공항과 여객 터미널 소개 및 출입국 안내
다양 나라 출입국 카드 정보|각국 출입국 카드 정보
출국 또 입국 위한 카드 신상 또 여권|출국과 입국을 위한 카드 신상 및 여권
여행 계획 관련하다 내용 기록 사용|여행 일정에 관한 내용을 기재하여 사용합니다.
부산 국제 여객 터미널|부산 국제 여객 터미널
해양 도시 부산 관문 역할|해양 도시 부산의 관문 역할을 수행하고 있다
인천 공항|인천 국제 공항
우리 나라 대표 인천 공항 곳 세계 공항 돕다 점수 1위 10년 동안 계속|인천 국제 공항은 세계 공항 서비스 평가 1위를 10년 이상 유지하고 있는 우리나라를 대표하는 공항입니다.
김포 공항|김포 국제 공항
제주 국제 공항|제주 국제 공항
제주도 우리 나라 대표 여행 곳 가장 큰 관문 곳 동쪽 북쪽 아시아 중간 곳 있다|우리나라의 대표 관광지인 제주도의 가장 큰 관문으로 동북아의 중앙부에 자리 잡아 
중국 일본 동쪽 남쪽 아시아 연결 때문 땅 의미 정부 정치 쭉 공부 가능 중요하다 곳|중국,일본,동남아를 연결하는 중요한 지정학적 위치에 있습니다.
청주 국제 공항|청주 국제 공항버스는
김해 국제 공항|김해 국제 공항